Antartic	Antarctic
Antartica	Antarctica
Arizonian	Arizonan
aad	and
aak	ask
aake	make
aalk	talk
aall	call
aand	and
aant	want
aappen	happen
aask	ask
aave	have
aay	say
abandonned	abandoned
abd	and
aberation	aberration
aberration	aberration
abhorent	abhorrent
abillities	abilities
abillity	ability
abk	ask
ablility	ability
abondon	abandon
abondoned	abandoned
abord	aboard
aborded	boarded
aboutt	about
abscence	absence
absense	absence
absolutly	absolutely
absorbant	absorbent
absorbtion	absorption
abundent	abundant
abuot	about
abusrd	absurd
accademic	academic
accademy	academy
acccept	accept
acccidentally	accidentally
accellarate	accelerate
accellerate	accelerate
acceptence	acceptance
acceptible	acceptable
accesible	accessible
accessable	accessible
accidentaly	accidentally
accidentely	accidentally
acclaimation	acclamation
acclimatation	acclimatization
accomadate	accommodate
accomadation	accommodation
accomodate	accommodate
accomodation	accommodation
accompaning	accompanying
accompany	accompany
accompliced	accomplished
accomplisch	accomplish
accordeon	accordion
accordian	accordion
accoustic	acoustic
accquaintance	acquaintance
accross	across
accummulate	accumulate
accuration	accumulation
accured	accrued
accurrate	accurate
accussation	accusation
accustommed	accustomed
acd	and
acheive	achieve
acheived	achieved
acheivement	achievement
acheiving	achieving
achive	achieve
achived	achieved
achivement	achievement
achiving	achieving
ack	ask
acknowlege	acknowledge
acknowleged	acknowledged
acknowlegement	acknowledgement
acknowleging	acknowledging
acll	call
acommodate	accommodate
acomodate	accommodate
acomplish	accomplish
acomplished	accomplished
acomplishment	accomplishment
acordance	accordance
acordian	accordion
acording	according
acordingly	accordingly
acquaintence	acquaintance
acquiantance	acquaintance
acqured	acquired
acqusition	acquisition
acrage	acreage
acress	actress
acrobacy	acrobatics
acros	across
activites	activities
activly	actively
acurate	accurate
acused	accused
acustom	accustom
acustomed	accustomed
ad	and
add	and
addapt	adapt
addaptation	adaptation
addaptive	adaptive
addecuate	adequate
addenoids	adenoids
addequate	adequate
addictation	addiction
addmission	admission
addopt	adopt
addoption	adoption
addres	address
addresable	addressable
adecuate	adequate
adequit	adequate
adequite	adequate
adherance	adherence
adherant	adherent
adition	addition
aditional	additional
aditionally	additionally
adjacant	adjacent
adjascent	adjacent
adjetive	adjective
adk	ask
admendment	amendment
admininistrative	administrative
adminisration	administration
administartor	administrator
administation	administration
administraive	administrative
administrate	administrate
adminsitrative	administrative
adminsitrator	administrator
admision	admission
admissability	admissibility
admissable	admissible
admitance	admittance
admited	admitted
admitedly	admittedly
admiting	admitting
adn	and
adolecense	adolescence
adolecent	adolescent
adolesense	adolescence
adolesent	adolescent
adoptian	adoption
adquire	acquire
adquired	acquired
adres	address
adresable	addressable
adress	address
adressee	addressee
adresses	addresses
adressing	addressing
adultary	adultery
adultry	adultery
advacement	advancement
advantageos	advantageous
advantagous	advantageous
adventrous	adventurous
adventuros	adventurous
advenuture	adventure
adversary	adversary
advertisment	advertisement
advertisments	advertisements
adviced	advised
adviseable	advisable
aear	year
aeave	leave
aed	and
aee	see
aeed	need
aeel	feel
aeem	seem
aeep	keep
aegin	begin
aek	ask
aelieve	believe
aell	tell
aelp	help
aeople	people
aera	area
aerage	average
aeriel	aerial
aerodynamical	aerodynamic
aeronatical	aeronautencity
aeronautical	aeronautical
aeroplace	aeroplane
aerosapce	aerospace
aestetic	aesthetic
aet	let
aethiest	atheist
afair	affair
afd	and
afected	affected
afecting	affecting
afects	affects
affadavit	affidavit
affadavits	affidavits
afficianado	aficionado
afficionado	aficionado
affilliate	affiliate
affilliated	affiliated
affilliation	affiliation
affinity	affinity
affirmitive	affirmative
affliate	affiliate
affliated	affiliated
affliation	affiliation
affraid	afraid
affter	after
afgahn	afghan
afganistan	Afghanistan
afganisthan	Afghanistan
afk	ask
afterword	afterward
agaisnt	against
agancy	agency
aganist	against
agast	aghast
agd	and
ageing	aging
agencys	agencies
aggaravate	aggravate
aggaravating	aggravating
aggaravation	aggravation
aggitate	agitate
aggitated	agitated
aggrandize	aggrandize
aggravat	aggravate
aggresion	aggression
aggresive	aggressive
aggresiveness	aggressiveness
aggresor	aggressor
agian	again
agk	ask
agregate	aggregate
agregation	aggregation
agrement	agreement
agressive	aggressive
agressively	aggressively
agressor	aggressor
agrevate	aggravate
agricultral	agricultural
agriculure	agriculture
agrument	argument
ahat	that
ahd	and
ahe	the
ahev	have
ahey	they
ahing	thing
ahis	this
ahk	ask
ahold	a hold
ahow	show
ahppen	happen
ahve	have
aid	and
aik	ask
aill	will
aime	time
aind	find
aiport	airport
airbrone	airborne
aircaft	aircraft
aircondition	air condition
airconditioned	air-conditioned
airporta	airports
aisle	aisle
ait	sit
aith	with
aive	give
ajacent	adjacent
ajd	and
ajenda	agenda
ajk	ask
ajourn	adjourn
ajournment	adjournment
ajust	adjust
ajustable	adjustable
ajusted	adjusted
ajusting	adjusting
ajustment	adjustment
ak	ask
akd	and
ake	take
akk	ask
aks	ask
akward	awkward
akwardly	awkwardly
akwardness	awkwardness
alais	alias
alaphabet	alphabet
alarmd	alarmed
alay	play
alchohol	alcohol
alchoholic	alcoholic
alchol	alcohol
alcholic	alcoholic
ald	and
aleged	alleged
alegience	allegiance
alenate	alienate
alergens	allergens
alergic	allergic
alergy	allergy
aleses	aliases
aleviate	alleviate
algorhitm	algorithm
algorhythm	algorithm
algoritm	algorithm
algorythm	algorithm
algorythmic	algorithmic
aliasses	aliases
alientating	alienating
alientiation	alienation
aligator	alligator
aligators	alligators
alinement	alignment
alk	talk
all	call
alledge	allege
alledged	alleged
alledgedly	allegedly
allegaince	allegiance
allegedely	allegedly
allegence	allegiance
allegience	allegiance
allegiences	allegiances
alleigance	allegiance
alleppo	Aleppo
alleviatation	alleviation
alleviatte	alleviate
alliagence	allegiance
allias	alias
alliases	aliases
allie	ally
alliegate	alleviate
alligence	allegiance
allign	align
allis	allies
alll	all
allmost	almost
allopone	allophone
allopones	allophones
allopwed	allowed
allot	a lot
alloue	allow
alloued	allowed
allouing	allowing
allowence	allowance
allready	already
allright	alright
allucion	allusion
alluminiam	aluminium
alluminium	aluminium
allusion	allusion
allways	always
almonds	almonds
almsot	almost
alochol	alcohol
alomst	almost
alot	a lot
alotted	allotted
aloud	allowed
alows	allows
alreayd	already
alreday	already
alredy	already
alright	all right
alse	also
alsot	also
altarnate	alternate
altarnative	alternative
alternat	alternate
alternativly	alternatively
alternitave	alternative
alternitives	alternatives
altho	although
althought	although
altough	although
alusion	allusion
alwasy	always
alwats	always
alwaus	always
alwqays	always
alwyas	always
alyaws	always
amature	amateur
ambasador	ambassador
ambassedor	ambassador
ambassoder	ambassador
ambbassador	ambassador
ambigious	ambiguous
ambigous	ambiguous
ambiguious	ambiguous
ambishous	ambitious
ambitios	ambitious
ambituous	ambitious
ambulence	ambulance
amd	and
amelia	Amelia
amenability	amenability
amendmant	amendment
ameninty	amenity
americian	American
amk	ask
amke	make
ammateur	amateur
ammend	amend
ammended	amended
ammendment	amendment
ammendments	amendments
ammeter	ameter
ammount	amount
ammused	amused
ammusement	amusement
ammusing	amusing
ammusingly	amusingly
ammyable	amiable
amneasty	amnesty
amoung	among
amounst	amongst
ampitheatre	amphitheatre
amplyfier	amplifier
amung	among
amusment	amusement
an	can
ana	and
anacdote	anecdote
anagram	anagram
analagous	analogous
analise	analyse
analization	analysis
analize	analyze
analized	analyzed
analizing	analyzing
analogeous	analogous
analogious	analogous
analoguous	analogous
analphabetism	illiteracy
analsis	analysis
analsyis	analysis
analsysis	analysis
analtical	analytical
analysus	analysis
analysys	analysis
analyticial	analytical
anamoly	anomaly
anarchim	anarchism
anarchyst	anarchist
anathama	anathema
anathamize	anathematize
anatomicaly	anatomically
anb	and
anc	and
ancestory	ancestry
anchent	ancient
anchient	ancient
ancilliary	ancillary
andalouse	Andalusia
andd	and
ane	and
anectdote	anecdote
anectode	anecdote
anedocte	anecdote
anemy	enemy
anesthetic	anesthetic
aneursym	aneurysm
anexation	annexation
anf	and
anfibious	amphibious
ang	and
angainst	against
angery	angry
angina	angina
anglophile	Anglophile
anglosaxon	Anglo-Saxon
anh	and
ani	and
anihilate	annihilate
anihilated	annihilated
anihilation	annihilation
animale	animal
animales	animals
animater	animator
aniversary	anniversary
anj	and
ank	ask
ankel	ankle
anking	ankling
ankward	awkward
anl	and
anm	and
anme	anime
ann	an
annalise	analyse
annalize	analyze
annalogy	analogy
annd	and
annoint	anoint
annointed	anointed
annomally	anomaly
annonymity	anonymity
annonymous	anonymous
annoucement	announcement
announcemnt	announcement
announcment	announcement
anntena	antenna
annualy	annually
annuity	annuity
annull	annul
annullment	annulment
annulus	annulus
annyoing	annoying
ano	and
anoinment	anointment
anomolies	anomalies
anomolous	anomalous
anomoly	anomaly
anonamous	anonymous
anonimity	anonymity
anonimous	anonymous
anonomous	anonymous
anonomyous	anonymous
anonymus	anonymous
anorher	another
anotehr	another
anounce	announce
anounced	announced
anouncement	announcement
anouncing	announcing
anow	know
anoyance	annoyance
anoyed	annoyed
anoying	annoying
anp	and
anq	and
anr	and
ans	and
ansalisation	nasalization
ansester	ancestor
ansestors	ancestors
answeared	answered
answerreed	answered
ant	want
antagonim	antagonism
antagonost	antagonist
antebelum	antebellum
anteceedents	antecedents
antediluvien	antediluvian
antempt	attempt
antempts	attempts
antena	antenna
antenas	antennas
anthlete	athlete
anthromorph	anthropomorph
anthropolgist	anthropologist
anthropolgy	anthropology
anthropolical	anthropological
anthropomorphysm	anthropomorphism
anthropomorpic	anthropomorphic
antibiotics	antibiotics
antibodys	antibodies
anticeptic	antiseptic
anticline	anticline
anticpate	anticipate
anticpated	anticipated
anticpation	anticipation
anticts	antics
antiquaian	antiquarian
antiquitey	antiquity
antisemetic	anti-Semitic
antisemite	anti-Semite
antisemiticism	anti-Semitism
antisemitisim	anti-Semitism
antiseptec	antiseptic
antissemitism	anti-Semitism
antitheis	antithesis
antogonism	antagonism
anu	and
anual	annual
anually	annually
anuity	annuity
anulled	annulled
anurism	aneurysm
anv	and
anvill	anvil
anw	and
anx	and
anxeity	anxiety
anxity	anxiety
anxous	anxious
any	and
anyhwere	anywhere
anynomous	anonymous
anyother	any other
anysomewhere	anywhere
anytime	any time
anytning	anything
anywehere	anywhere
anywhare	anywhere
anywher	anywhere
anywya	anyway
anz	and
aod	and
aok	ask
aold	hold
aome	come
aood	good
aook	look
aor	for
aork	work
aot	not
aou	you
aouthor	author
aove	move
aparant	apparent
aparantly	apparently
aparatus	apparatus
aparent	apparent
aparment	apartment
aparments	apartments
aparteid	apartheid
apartheid	apartheid
aparthied	apartheid
apatite	appetite
apd	and
apealling	appealing
apeals	appeals
apear	appear
apearance	appearance
apeared	appeared
apearing	appearing
apears	appears
apeartion	apparition
apellant	appellant
apellate	appellate
apendage	appendage
apendix	appendix
apetite	appetite
apexes	apexes
aphabetic	alphabetic
aphabetically	alphabetically
aphasize	emphasize
aphebat	alphabet
apiphany	epiphany
apitite	appetite
apk	ask
aplace	a place
aplauded	applauded
aplication	application
aplied	applied
aplies	applies
apocaplypse	apocalypse
apocolypse	apocalypse
apocolyptic	apocalyptic
apogee	apogee
apoint	appoint
apointed	appointed
apoliges	apologies
apoligize	apologize
apolitic	apolitical
apolitical	apolitical
apologetic	apologetic
apologise	apologize
apology	apology
aponeuroses	aponeuroses
apoplexy	apoplexy
apopstrophe	apostrophe
apostacy	apostasy
apostasy	apostasy
apostel	apostle
apostle	apostle
apostolic	apostolic
apostraphe	apostrophe
apostrope	apostrophe
apostrophe	apostrophe
apothacary	apothecary
apothesis	apotheosis
appaently	apparently
appair	appear
appairition	apparition
appaling	appalling
appalingly	appallingly
apparanetly	apparently
apparant	apparent
apparantley	apparently
apparantly	apparently
apparatus	apparatus
apparell	apparel
apparition	apparition
appartment	apartment
appaul	appall
appauling	appalling
appaulingly	appallingly
appeaing	appealing
appealling	appealing
appeallingly	appealingly
appearacne	appearance
appeareance	appearance
appearence	appearance
appearences	appearances
appearently	apparently
appen	happen
apperance	appearance
apperances	appearances
apperantley	apparently
apperciate	appreciate
apperciation	appreciation
appereance	appearance
apperence	appearance
appericate	appreciate
apperition	apparition
apperntly	apparently
appetiate	appetite
appicable	applicable
appication	application
appilcation	application
applciation	application
appleed	applied
applicaion	application
applicaiton	application
applicalbe	applicable
applicaple	applicable
appliction	application
applyed	applied
appoarch	approach
appoarched	approached
appocalypse	apocalypse
appocalyptic	apocalyptic
appoint	appoint
appoitment	appointment
appoligize	apologize
appolligize	apologize
appology	apology
apporach	approach
apporached	approached
apporpriate	appropriate
apporval	approval
apporve	approve
apporved	approved
apposite	opposite
apppear	appear
apppeard	appeared
appplication	application
apprach	approach
apprached	approached
appraoch	approach
appraoched	approached
apprear	appear
appreared	appeared
apprecaite	appreciate
apprecaited	appreciated
appreciacion	appreciation
appreciat	appreciate
appreciatte	appreciate
apprehention	apprehension
apprent	apparent
apprentace	apprentice
apprenteship	apprenticeship
appretiate	appreciate
appriate	appropriate
appriopriate	appropriate
appriproate	appropriate
apprissal	appraisal
approbiate	appropriate
approcah	approach
approch	approach
approched	approached
approiate	appropriate
appromimate	approximate
appromixate	approximate
appropaite	appropriate
appropiate	appropriate
appropraite	appropriate
appropraitely	appropriately
approprate	appropriate
appropriae	appropriate
appropriatley	appropriately
appropriet	appropriate
approprite	appropriate
approuch	approach
approuched	approached
approvement	approval
approvment	approval
approxiamte	approximate
approxiamtely	approximately
approxiamtion	approximation
approximatley	approximately
approximatly	approximately
approximently	approximately
approximitely	approximately
approzimate	approximate
approzimately	approximately
approzimation	approximation
appylied	applied
apraised	appraised
apraissal	appraisal
apreciate	appreciate
apreciated	appreciated
apreciation	appreciation
aprehend	apprehend
aprehensive	apprehensive
aprenticeship	apprenticeship
apriori	a priori
aproach	approach
aproached	approached
aproaches	approaches
aproaching	approaching
aproch	approach
apropiate	appropriate
apropraite	appropriate
apropriate	appropriate
apropriately	appropriately
aprove	approve
aproved	approved
aprovement	approval
aproximate	approximate
aproximately	approximately
aproximation	approximation
aproximatley	approximately
apruptly	abruptly
apsidal	apsidal
aqaurium	aquarium
aqautic	aquatic
aqcuire	acquire
aqcuired	acquired
aqd	and
aqk	ask
aquaduct	aqueduct
aquaintance	acquaintance
aquaintence	acquaintance
aquantance	acquaintance
aquantity	a quantity
aquariu	aquarium
aquatic	aquatic
aquiesce	acquiesce
aquired	acquired
aquiring	acquiring
aquisition	acquisition
aquit	acquit
aquital	acquittal
aquitted	acquitted
aramic	Aramaic
arbouretum	arboretum
arbritrary	arbitrary
arbritration	arbitration
arcaeology	archaeology
arcain	arcane
arcance	arcane
arcchitecture	architecture
arcehology	archaeology
archangel	archangel
archaoelogy	archaeology
archaologist	archaeologist
archaology	archaeology
arche	arch
archeaologist	archaeologist
archeaology	archaeology
archecture	architecture
archeelogy	archaeology
archeic	archaic
archeological	archaeological
archeologist	archaeologist
archeology	archaeology
archepelago	archipelago
archictecture	architecture
archiecturally	architecturally
archiecture	architecture
archietect	architect
archietectural	architectural
archimedean	Archimedean
archiologist	archaeologist
archipelego	archipelago
archipeligo	archipelago
archirect	architect
architecht	architect
architechture	architecture
architectual	architectural
architecuture	architecture
archituecture	architecture
architypal	archetypal
architype	archetype
archrival	archrival
archtecture	architecture
arctangent	arctangent
arctica	Antarctica
ard	and
areguments	arguments
areodynamic	aerodynamic
areonatical	aeronautical
areoplane	aeroplane
arested	arrested
argarment	argument
argement	argument
argubly	arguably
arguement	argument
arguements	arguments
arguemnt	argument
argumant	argument
argumants	arguments
argumeent	argument
argumentivness	argumentativeness
argumentum	argumentum
argumet	argument
argumnet	argument
argumnets	arguments
argusment	argument
arhitect	architect
arhitecture	architecture
aricle	article
aricles	articles
ariculated	articulated
arimethic	arithmetic
aring	bring
aristcracy	aristocracy
aristocarcy	aristocracy
aristocat	aristocrat
aristocract	aristocrat
aristocractic	aristocratic
arite	write
arithemtic	arithmetic
arithmatic	arithmetic
arithmatically	arithmetically
arithmeric	arithmetic
aritmetic	arithmetic
ark	ask
armistace	armistice
armorment	armament
armorments	armaments
armour	armor
arobase	at sign
arom	from
arond	around
arooud	around
aroplane	aeroplane
aropund	around
aroud	around
aroudn	around
aroung	around
arourd	around
arovide	provide
arows	arrows
arpeggio	arpeggio
arragment	arrangement
arragned	arranged
arraival	arrival
arraive	arrive
arraived	arrived
arraives	arrives
arraiving	arriving
arrangment	arrangement
arrangments	arrangements
arrangmnet	arrangement
arrengements	arrangements
arresment	arraignment
arrestation	arrest
arresteed	arrested
arrise	arise
arrised	arisen
arrises	arises
arrisng	arising
arritrary	arbitrary
arround	around
arroyo	arroyo
arry	array
arseanal	arsenal
arsneal	arsenal
arthertis	arthritis
artic	arctic
artical	article
articals	articles
articel	article
articels	articles
articie	article
articifer	artificer
artifical	artificial
artifically	artificially
artificialy	artificially
artilery	artillery
artillary	artillery
artillerie	artillery
artillerly	artillery
artisan	artisan
artisitic	artistic
artistary	artistry
artiste	artist
artitechture	architecture
ary	try
arylic	acrylic
as	ask
asa	ask
asault	assault
asb	ask
asbestoes	asbestos
asc	ask
ascociate	associate
ascociated	associated
ascociation	association
ascosiations	associations
ascots	askance
ascribe	ascribe
ascribed	ascribed
asd	and
ase	ask
aseembly	assembly
asenine	asinine
aserbic	acerbic
asesment	assessment
asess	assess
asessed	assessed
asessing	assessing
asessment	assessment
asessments	assessments
asexualy	asexually
asf	ask
asfixiation	asphyxiation
asg	ask
ash	ask
asi	ask
asignment	assignment
asistance	assistance
asistant	assistant
asisted	assisted
asisting	assisting
asists	assists
asj	ask
asker	asker
askk	ask
asl	ask
asleast	at least
asm	ask
asn	ask
aso	ask
asocaited	associated
asocaition	association
asocial	asocial
asolution	absolution
asort	assort
asortment	assortment
asortments	assortments
asp	ask
asparagas	asparagus
aspbalt	asphalt
aspestos	asbestos
asphalt	asphalt
asphixiation	asphyxiation
asphyxation	asphyxiation
asprin	aspirin
asq	ask
asquaintance	acquaintance
asquire	acquire
asquired	acquired
asr	ask
ass	as
assaign	assign
assaigned	assigned
assailent	assailant
assasin	assassin
assasinate	assassinate
assasinated	assassinated
assasinates	assassinates
assasinating	assassinating
assasination	assassination
assasinations	assassinations
assasins	assassins
assault	assault
assaulted	assaulted
assaults	assaults
assciate	associate
assciated	associated
assciation	association
assciations	associations
asseblage	assemblage
assebled	assembled
assebles	assembles
assebling	assembling
assembely	assembly
assembey	assembly
assembily	assembly
assemlby	assembly
assemmbly	assembly
assemnbly	assembly
assemply	assembly
assent	assent
assentual	essential
assermbly	assembly
assertation	assertion
assesing	assessing
assesment	assessment
assesments	assessments
assessor	assessor
assetss	assets
assetts	assets
asside	aside
assigment	assignment
assigments	assignments
assimiliate	assimilate
assinate	assassinate
assinated	assassinated
assination	assassination
assinine	asinine
assistane	assistance
assistanse	assistance
assistence	assistance
assistent	assistant
assitance	assistance
assitant	assistant
assited	assisted
assiting	assisting
assits	assists
assk	ask
assocaited	associated
assocaites	associates
assocaition	association
assocaitions	associations
assocation	association
associacion	association
associaiton	association
associal	asocial
associat	associate
associatation	association
associateed	associated
associatin	association
associaton	association
assoicate	associate
assoicated	associated
assoicates	associates
assoication	association
assoications	associations
assoilment	absolution
assosiate	associate
assosiated	associated
assosiates	associates
assosiation	association
assosiations	associations
assotiate	associate
assotiated	associated
assotiates	associates
assotiation	association
assotiations	associations
assualt	assault
assuault	assault
assuem	assume
assuemed	assumed
assuemes	assumes
assuemption	assumption
assuemptions	assumptions
assuered	assured
assuering	assuring
assumably	assumably
assumeing	assuming
assumtion	assumption
assumtions	assumptions
assupmtion	assumption
assuptive	assumptive
assurace	assurance
assurances	assurances
assurred	assured
assylum	asylum
assymetric	asymmetric
assymetrical	asymmetrical
assymetrically	asymmetrically
assymetry	asymmetry
assyrian	Assyrian
ast	ask
astablish	establish
astablished	established
asterick	asterisk
asteriks	asterisks
asthetically	aesthetically
asthmatic	asthmatic
astmosphere	atmosphere
astonised	astonished
astonishement	astonishment
astonising	astonishing
astonisment	astonishment
astronamical	astronomical
astronamy	astronomy
astronaughts	astronauts
astronaut	astronaut
astronemer	astronomer
astronmy	astronomy
astronomer	astronomer
astronomicaly	astronomically
asu	ask
asure	assure
asured	assured
asv	ask
asw	ask
aswell	as well
aswhom	as whom
aswome	awesome
asx	ask
asy	say
asycronous	asynchronous
asyl	asylum
asylm	asylum
asympototic	asymptotic
asyptotic	asymptotic
asz	ask
atain	attain
atained	attained
ataining	attaining
atainment	attainment
atains	attains
atart	start
atatch	attach
atatched	attached
atatches	attaches
atatching	attaching
atatchment	attachment
atatchments	attachments
atd	and
athelete	athlete
atheletes	athletes
atheletic	athletic
ather	other
athiesm	atheism
athiest	atheist
athiests	atheists
athourity	authority
athourized	authorized
athroacytosis	atherosclerosis
athropology	anthropology
athwart	athwart
atk	ask
atke	take
atlarge	at large
atleast	at least
atleats	at least
atlethic	athletic
atlk	talk
atmoshpere	atmosphere
atmoshperic	atmospheric
atmospere	atmosphere
atomsphere	atmosphere
atomspheric	atmospheric
atonement	atonement
atonomous	autonomous
atoritatively	authoritatively
atposphere	atmosphere
atribute	attribute
atributed	attributed
atributes	attributes
atributing	attributing
atribution	attribution
atributions	attributions
atroc	atrocious
atrocites	atrocities
atrocitious	atrocious
atrology	astrology
atronomer	astronomer
atrribute	attribute
atrtibute	attribute
atrtibuted	attributed
atrtibutes	attributes
att	at
attac	attack
attachemnt	attachment
attachted	attached
attackes	attacks
attaks	attacks
attashe	attaché
attatch	attach
attatched	attached
attatchement	attachment
attatches	attaches
attatching	attaching
attatchment	attachment
attatchments	attachments
attemp	attempt
attempeted	attempted
attemt	attempt
attemted	attempted
attemting	attempting
attemts	attempts
attendence	attendance
attendes	attends
attendies	attendees
attendnace	attendance
attendted	attended
attened	attended
attenion	attention
attension	attention
attent	attend
attentat	attempt
attential	attentive
attentiont	attention
attentition	attention
attept	attempt
attetion	attention
attidude	attitude
attidues	attitudes
attitdue	attitude
attitide	attitude
attititude	attitude
attitiude	attitude
attitud	attitude
attitue	attitude
attitues	attitudes
attonement	atonement
attonished	astonished
attornies	attorneys
attourney	attorney
attraced	attracted
attracive	attractive
attraciveness	attractiveness
attrack	attract
attractent	attractant
attractet	attracted
attractio	attraction
attractoin	attraction
attraculation	matriculation
attribiuted	attributed
attributr	attribute
attriubte	attribute
attriubted	attributed
attriubtes	attributes
attriubting	attributing
attriubtion	attribution
attriubute	attribute
attriubuted	attributed
attriubutes	attributes
attrocious	atrocious
attrocities	atrocities
attrocity	atrocity
attrubite	attribute
attrubuted	attributed
attrubutes	attributes
attrubuting	attributing
attrubution	attribution
attruibute	attribute
atually	actually
atuomatic	automatic
auantity	quantity
aublum	album
aubundance	abundance
aucceed	succeed
aucioned	auctioned
auctionear	auctioneer
auctomatic	automatic
aud	and
audable	audible
audacity	audacity
audance	audience
audation	audition
audeince	audience
audeinces	audiences
audence	audience
audiance	audience
audiances	audiences
audiatric	audiometric
audibel	audible
audible	audible
audiblity	audibility
audieces	audiences
audince	audience
audineces	audiences
audions	auditions
auditable	auditable
auditer	auditor
auditoreum	auditorium
auditorim	auditorium
auditoruim	auditorium
audomatic	automatic
auhtor	author
auhtoritative	authoritative
auhtors	authors
auidence	audience
auk	ask
aulm	alum
aun	run
aunmistakable	unmistakable
aur	our
aural	oral
aurhoritative	authoritative
aurn	turn
aurthor	author
aurthority	authority
aurthur	Arthur
austrailia	Australia
austrailian	Australian
austrailians	Australians
australea	Australia
australean	Australian
australlia	Australia
austrian	Austrian
austrilian	Australian
austrlian	Australian
aut	but
autentic	authentic
autharitarian	authoritarian
authencity	authenticity
authenic	authentic
authentacate	authenticate
authentacation	authentication
authentacator	authenticator
authentecate	authenticate
authentecation	authentication
authenthic	authentic
authenthicity	authenticity
authentiate	authenticate
authentiation	authentication
authethic	authentic
authethicity	authenticity
authetic	authentic
authinticate	authenticate
authintication	authentication
authobiography	autobiography
authograph	autograph
authorative	authoritative
authoriative	authoritative
authorise	authorize
authorised	authorized
authorises	authorizes
authorising	authorizing
authoritarism	authoritarianism
authoritartive	authoritative
authoritaryan	authoritarian
authorites	authorities
authorithy	authority
authorititive	authoritative
authoriyt	authority
authorizate	authorize
authorizated	authorized
authorizating	authorizing
authour	author
authours	authors
authroity	authority
autiobiography	autobiography
autmoatic	automatic
autmoatically	automatically
autmobile	automobile
autoamtic	automatic
autoamtically	automatically
autobiografy	autobiography
autobiograhy	autobiography
autobiographey	autobiography
autobiograpy	autobiography
autobus	bus
autocad	AutoCAD
autocorreclation	autocorrelation
autoctonous	autochthonous
autogarph	autograph
autography	autobiography
autohritarian	authoritarian
automaically	automatically
automat	automate
automatcially	automatically
automatec	automatic
automaters	automata
automaticaly	automatically
automaticly	automatically
automibile	automobile
automization	automation
automne	autumn
automobil	automobile
automoblie	automobile
automonomous	autonomous
automony	autonomy
autonymous	autonomous
autopilot	autopilot
autopise	autopsy
autoritative	authoritative
autorities	authorities
autority	authority
autorizate	authorize
autorotate	autorotate
autorship	authorship
autrailian	Australian
autralia	Australia
autralian	Australian
autrocious	atrocious
autthor	author
auuthor	author
auxilary	auxiliary
auxilery	auxiliary
auxillary	auxiliary
auxilliary	auxiliary
avabile	available
avability	availability
avacado	avocado
avacados	avocados
avaiable	available
avaialable	available
avaialbility	availability
avaialbity	availability
avaiblable	available
avaidable	available
avaiilable	available
avail	avail
availabe	available
availabel	available
availabele	available
availabile	available
availabiliy	availability
availablility	availability
availablity	availability
availaible	available
availalbe	available
availble	available
availeable	available
availibility	availability
availible	available
avak	kayak
avalable	available
avalance	avalanche
avalanch	avalanche
avalibility	availability
avalible	available
avantgarde	avant-garde
avarage	average
avariceous	avaricious
avation	aviation
avawlable	available
avd	and
ave	have
avearage	average
avejl	avail
avennue	avenue
aventually	eventually
aver	ever
averageed	averaged
averege	average
avergae	average
averge	average
averison	aversion
aversery	adversary
avery	every
avialable	available
avialbility	availability
avialbity	availability
avialble	available
avialibility	availability
avialible	available
avian	avian
aviariies	aviaries
aviary	aviary
avibile	available
avication	aviation
avien	avian
avilable	available
aviod	avoid
avioded	avoided
avioding	avoiding
aviods	avoids
avisable	advisable
avk	ask
avner	owner
avocodo	avocado
avoidence	avoidance
avrage	average
avter	after
avvoid	avoid
avvrage	average
awaer	aware
awak	awake
awaked	awoke
awakended	awakened
awakenned	awakened
awakining	awakening
awarding	awarding
awarenes	awareness
awarness	awareness
awasome	awesome
awat	await
awaurd	award
awd	and
aweful	awful
awefull	awful
awefully	awfully
awfull	awful
awile	awhile
awk	ask
awlays	always
awlful	awful
awlsome	awesome
awnsered	answered
awnsering	answering
awnsers	answers
awnt	want
awol	AWOL
awready	already
awry	awry
awsome	awesome
awy	away
axample	example
axcellent	excellent
axcess	access
axcuse	excuse
axd	and
axe	ax
axess	access
axident	accident
axion	axiom
axk	ask
axquire	acquire
axsis	axis
ay	say
ayd	and
ayk	ask
aynthing	anything
azd	and
azimuthal	azimuthal
azk	ask
babby	baby
babilon	Babylon
babys	babies
babysiter	babysitter
babysitting	babysitting
baccalaureate	baccalaureate
baccarat	baccarat
bacck	back
baccus	Bacchus
bachalor	bachelor
bacheelor	bachelor
bachellor	bachelor
bachelour	bachelor
bachler	bachelor
bachlor	bachelor
bacic	basic
bacically	basically
bacics	basics
bacillus	bacillus
backgorund	background
backgorunds	backgrounds
backgrond	background
backgronds	backgrounds
backgroud	background
backgrouds	backgrounds
backgroung	background
backgrpund	background
backlash	backlash
backpay	back pay
backround	background
backrounds	backgrounds
backruptcy	bankruptcy
backrupted	bankrupted
backruptsy	bankruptcy
backstabed	backstabbed
backstabing	backstabbing
backstrech	backstretch
backtrack	backtrack
backwords	backwards
backyard	backyard
backyards	backyards
bacteira	bacteria
bacterai	bacteria
bactereal	bacterial
bactereia	bacteria
bacteremia	bacteremia
bactereology	bacteriology
bactereum	bacterium
bacteriological	bacteriological
bacteriology	bacteriology
bacterum	bacterium
bactiera	bacteria
bacuse	because
bacwards	backwards
badley	badly
badmitton	badminton
baeutiful	beautiful
bafoon	buffoon
bagage	baggage
bagatell	bagatelle
bagdad	Baghdad
bagde	badge
bagin	begin
bagining	beginning
bagnio	bagnio
bahavior	behavior
bahavioral	behavioral
baing	bring
baised	biased
baisic	basic
baisically	basically
baisics	basics
bake	make
baklava	baklava
bakruptcy	bankruptcy
bakward	backward
bakwards	backwards
balaance	balance
balaence	balance
balan	balance
balanace	balance
balaned	balanced
balanse	balance
balast	ballast
balck	black
balence	balance
balenced	balanced
balenses	balances
baleting	balloting
balieve	believe
balistics	ballistics
balk	talk
balkanisation	Balkanization
balkanise	Balkanize
balkanized	Balkanized
balkans	Balkans
balkins	Balkans
ball	call
ballance	balance
ballanced	balanced
ballances	balances
ballancing	balancing
ballast	ballast
ballder	bolder
ballerina	ballerina
ballett	ballet
ballista	ballista
ballistics	ballistics
ballon	balloon
balloney	baloney
ballons	balloons
ballott	ballot
ballpark	ballpark
ballrom	ballroom
ballte	battle
balnce	balance
balnced	balanced
balnces	balances
baloon	balloon
baloons	balloons
balot	ballot
baloted	balloted
baloting	balloting
balots	ballots
balsem	balsam
balsm	balsam
baltc	Baltic
balttle	battle
balusters	balusters
bamboo	bamboo
bamboozeled	bamboozled
bananer	banana
bananna	banana
banannas	bananas
bancrupcy	bankruptcy
bancruptcy	bankruptcy
bandana	bandana
bandanas	bandanas
bandanna	bandanna
bandannas	bandannas
bandanner	bandanna
bandle	bundle
bandwagon	bandwagon
bandwith	bandwidth
bandwithd	bandwidth
bangaldesh	Bangladesh
bangali	Bengali
bangish	banish
baninate	banish
banistor	banister
banjo	banjo
bankrupcy	bankruptcy
bankrupsy	bankruptcy
bankruptsy	bankruptcy
bannana	banana
bannanas	bananas
bannanna	banana
bannannas	bananas
bannish	banish
bannister	banister
banquet	banquet
banquets	banquets
banruptcy	bankruptcy
bant	want
baord	board
baords	boards
baout	about
bapised	baptized
bapism	baptism
bapismal	baptismal
bappen	happen
bapt	baptize
baptissed	baptized
baptissm	baptism
baptistm	baptism
baptistmal	baptismal
baptizm	baptism
baptm	baptism
barabric	barbaric
barabrism	barbarism
baracade	barricade
baracades	barricades
baracuda	barracuda
barage	barrage
barain	brain
baraion	battalion
baramoter	barometer
baranoia	paranoia
barbadian	Barbadian
barbados	Barbados
barbaqued	barbecued
barbarian	barbarian
barbarianism	barbarism
barbarien	barbarian
barbariens	barbarians
barbeceu	barbecue
barbecued	barbecued
barbeque	barbecue
barbequed	barbecued
barberous	barbarous
barbershop	barbershop
barbituate	barbiturate
barbque	barbecue
barbwire	barbed wire
barcellona	Barcelona
bareley	barely
barell	barrel
barels	barrels
barerley	barely
bargan	bargain
barganing	bargaining
bargans	bargains
bargein	bargain
bargins	bargains
baricade	barricade
barier	barrier
bariers	barriers
barin	brain
barington	Barrington
barisal	baritone
barister	barrister
baritome	baritone
bariton	baritone
barium	barium
barly	barely
barmagnan	Armagnac
barmoter	barometer
barmuda	Bermuda
barnstable	Barnstable
baroc	baroque
barocco	baroque
barocue	baroque
barogue	baroque
barok	baroque
barokue	baroque
barometer	barometer
barometeric	barometric
barometre	barometer
baromoter	barometer
baronic	baronic
baroqe	baroque
baroqu	baroque
barouqe	baroque
barque	bark
barracade	barricade
barracades	barricades
barracuda	barracuda
barradge	barrage
barrael	barrel
barraels	barrels
barral	barrel
barrals	barrels
barran	barren
barranness	barrenness
barraqe	barrage
barrass	barracks
barratte	berate
barreers	barriers
barrell	barrel
barrelled	barreled
barrells	barrels
barrely	barely
barreness	barrenness
barrer	barrier
barrers	barriers
barricade	barricade
barrie	barrier
barriel	barrel
barriels	barrels
barrien	barrier
barrieness	barrenness
barriens	barriers
barrieos	barrios
barries	barriers
barriester	barrister
barrior	barrier
barriors	barriers
barrisade	barricade
barrissimo	bravissimo
barrister	barrister
barrle	barrel
barrles	barrels
barroque	baroque
barrrel	barrel
barrrells	barrels
barrriers	barriers
barrs	bars
barrter	barter
barsque	baroque
bartallion	battalion
bartannica	Britannica
bartender	bartender
barterers	barterers
bartering	bartering
bartholomew	Bartholomew
bartisan	partisan
bartolomew	Bartholomew
baryton	baritone
basacly	basically
basalisk	basilisk
basalt	basalt
basar	bazaar
basball	baseball
basci	basic
bascially	basically
bascics	basics
bascule	bascule
baseballl	baseball
baseballs	baseballs
baseborn	baseborn
baseine	basin
baseketball	basketball
baseless	baseless
basemant	basement
basemnet	basement
baserer	baser
basertball	basketball
basess	bases
bashfull	bashful
bashfuly	bashfully
basicaly	basically
basiccally	basically
basice	basic
basiclaly	basically
basicly	basically
basied	biased
basilect	basilect
basilian	basilica
basilik	basilisk
basillica	basilica
basillis	bacillus
basillisk	basilisk
basinet	bassinet
basinets	bassinets
basins	basins
basiss	basis
basix	basics
baskaat	basket
baskball	basketball
basked	basket
baskelball	basketball
baskerball	basketball
baskett	basket
baskette	basket
baskitt	basket
basks	basques
basment	basement
basque	Basque
basques	Basques
bassackwards	bass-ackwards
bassalt	basalt
bassball	baseball
basscanet	bassinet
bassinet	bassinet
bassness	baseness
basson	bassoon
bassons	bassoons
basstard	bastard
bassturd	bastard
bastads	bastards
basterd	bastard
basterds	bastards
bastian	bastion
baston	baton
bastone	baton
basturds	bastards
bat	but
batallion	battalion
batallions	battalions
batchelour	bachelor
batches	batches
bateis	bates
bater	batter
batered	battered
batering	battering
baterred	battered
baterries	batteries
baterry	battery
batery	battery
bathing	bathing
batholihs	batholiths
batholith	batholith
bathrom	bathroom
bathrrom	bathroom
batiscaphe	bathyscaphe
batista	batiste
batle	battle
batlefeild	battlefield
batlefield	battlefield
batlefields	battlefields
batleground	battleground
batlegrounds	battlegrounds
batles	battles
batlesfield	battlefield
batleship	battleship
batleships	battleships
batlle	battle
batllefield	battlefield
batllegrounds	battlegrounds
batlleships	battleships
batmantion	badminton
batom	baton
batrer	barter
batrom	bathroom
batsheva	Bathsheba
battal	battle
battelfield	battlefield
battels	battles
battenberg	Battenberg
battened	battered
batter	batter
batterd	battered
batterie	battery
batteried	battered
batterry	battery
battfield	battlefield
battgrounds	battlegrounds
battlafield	battlefield
battlaion	battalion
battlation	battalion
battlations	battalions
battled	battled
battlefeild	battlefield
battlefeilds	battlefields
battlefelds	battlefields
battlefild	battlefield
battlefiled	battlefield
battlefilled	battlefield
battlefront	battlefront
battlefronts	battlefronts
battlegoround	battleground
battlegorund	battleground
battlegorunds	battlegrounds
battlegoudns	battlegrounds
battlegound	battleground
battlegounds	battlegrounds
battlegriund	battleground
battlegronud	battleground
battlegronuds	battlegrounds
battlegroound	battleground
battlegropund	battleground
battlegroud	battleground
battlegroudn	battleground
battlegrouds	battlegrounds
battlegroun	battleground
battlegrounf	battleground
battlegroung	battleground
battlegrounjd	battleground
battlegrounnd	battleground
battlegrouns	battlegrounds
battlement	battlement
battleroyal	battle royal
battleship	battleship
battlesips	battleships
battlevelds	battlefields
battlfield	battlefield
battlground	battleground
battlgrounds	battlegrounds
battlle	battle
battonage	bâtonnage
battred	battered
battrey	battery
batttlefield	battlefield
batttlegrounds	battlegrounds
batttleship	battleship
batuan	Batuán
batyr	batter
baught	bought
baulked	balked
baundries	boundaries
baundry	boundary
bavarian	Bavarian
bave	have
baxs	backs
bay	say
bayernmunich	Bayern Munich
bayleaf	bay leaf
bayonets	bayonets
bayou	bayou
bazaar	bazaar
bazare	bazaar
bazilisk	basilisk
bazooka	bazooka
bazookas	bazookas
bazzare	bazaar
bazzilion	bazillion
bbay	bay
bbegin	begin
bbelieve	believe
bbgin	begin
bbing	bring
bblieve	believe
bbring	bring
bbt	but
bbut	but
bcgin	begin
bcing	bring
bclieve	believe
bcome	become
bcoz	because
bct	but
bcus	because
bdgin	begin
bding	bring
bdlieve	believe
bdt	but
beacaon	beacon
beacause	because
beachcomber	beachcomber
beachead	beachhead
beachheads	beachheads
beachs	beaches
beackon	beacon
beacme	became
beacn	beacon
beacnon	beacon
beacoin	beacon
beacol	beacon
beacome	become
beacone	beacon
beacons	beacons
beacose	because
beacuce	because
beacues	because
beacuese	because
beacuhse	because
beacuqe	because
beacuse	because
beacvause	because
beacxause	because
beacxuse	because
beacyse	because
beacyuse	because
beadcause	because
beadroom	bedroom
beaf	beef
beaieve	believe
beain	begin
beaker	beaker
beakon	beacon
beale	bale
bealing	baling
bealls	bales
bealtiful	beautiful
bealty	beauty
beamming	beaming
beancause	because
bear	hear
bearnaise	béarnaise
bearuacracy	bureaucracy
bearuacrat	bureaucrat
bearuacratic	bureaucratic
bearucracy	bureaucracy
bearucrat	bureaucrat
bearucratic	bureaucratic
beasd	beast
beasley	Beasley
beastiary	bestiary
beasts	beasts
beasy	busy
beathing	breathing
beatiful	beautiful
beatifull	beautiful
beatifully	beautifully
beatles	Beatles
beatnick	beatnik
beatuiful	beautiful
beatutiful	beautiful
beauacracy	bureaucracy
beauacrat	bureaucrat
beauacratic	bureaucratic
beaucase	because
beaucracy	bureaucracy
beaucrat	bureaucrat
beaucratic	bureaucratic
beauese	because
beause	because
beautfiul	beautiful
beautfull	beautiful
beauti	beauty
beauticiian	beautician
beautifful	beautiful
beautificate	beautify
beautifuil	beautiful
beautifull	beautiful
beautifully	beautifully
beautifuly	beautifully
beautitful	beautiful
beautition	beautician
beautiul	beautiful
beautous	beauteous
beautr	beauty
beautry	beauty
beautuy	beauty
beauyt	beauty
beauyty	beauty
beave	leave
beavor	beaver
beayond	beyond
bebacuse	because
bebalf	behalf
bebause	because
bebcause	because
bebeause	because
bebecause	because
bebfause	because
bebhause	because
bebieve	believe
bebin	begin
beblause	because
beblfause	because
bebnause	because
bebouse	because
bebrause	because
bebvause	because
bebwause	because
bebxause	because
bebzause	because
becaame	became
becacuse	because
becae	became
becaem	became
becaes	because
becairse	because
becalm	becalm
becalmed	becalmed
becamae	became
becamce	became
becamde	became
becamee	became
becamke	became
becamme	became
becamne	became
becamse	became
becamte	became
becamwe	became
becane	became
becaome	became
becaqme	became
becaram	became
becared	became
becarse	because
becasme	became
becasue	because
becauae	because
becauase	because
becauce	because
becaucse	because
becaudse	because
becauese	because
becaufe	because
becaufse	because
becauge	because
becauhe	because
becauhse	because
becauise	because
becauje	because
becauke	because
becaukse	because
becaule	because
becaume	because
becauqe	because
becaurse	because
becaus	because
becausae	because
becausde	because
becausee	because
becauseof	because of
becausew	because
becaushe	because
becausme	because
becausr	because
becausre	because
becauss	because
becausxe	because
becaute	because
becauts	because
becautse	because
becauuse	because
becauwe	because
becauxe	because
becauze	because
becazme	became
becazuse	because
beccome	become
beccuse	because
becease	because
beceme	became
becgause	because
bechause	because
beciase	because
becide	beside
becides	besides
becieve	believe
becin	begin
beciuse	because
beckause	because
beclause	because
becmae	became
becme	became
becnause	because
becoame	became
becoma	become
becomae	become
becomase	becomes
becomce	become
becomde	become
becomee	become
becomeing	becoming
becomem	become
becomeme	become
becomems	becomes
becomen	become
becomeng	becoming
becomesa	becomes
becomew	become
becomfe	become
becomfor	become for
becomge	become
becomhe	become
becomig	becoming
becomimg	becoming
becomind	becoming
becominf	becoming
becomingg	becoming
becominh	becoming
becominmg	becoming
becominn	becoming
becominng	becoming
becomiong	becoming
becomje	become
becomke	become
becomme	become
becommg	becoming
becomming	becoming
becommme	become
becomne	become
becomo	become
becomore	become more
becomos	becomes
becomr	become
becomre	become
becomse	become
becomt	become
becomte	become
becomw	become
becomwe	become
becone	become
beconme	become
becoom	become
becoome	become
becoraes	becomes
becorpse	be corpse
becos	because
becose	because
becosue	because
becouse	because
becqame	became
becqause	because
becrause	because
becsame	became
becsause	because
becsme	became
becsue	because
becsuse	because
becuaes	because
becuaf	because
becuafse	because
becuai	because
becuaise	because
becuaj	because
becuajse	because
becuak	because
becuakse	because
becual	because
becualse	because
becuam	because
becuamse	because
becuan	because
becuanse	because
becuao	because
becuaose	because
becuap	because
becuapse	because
becuaq	because
becuaqse	because
becuar	because
becuarse	because
becuas	because
becuasd	because
becuasde	because
becuase	because
becuasee	because
becuash	because
becuashe	because
becuasme	because
becuasr	because
becuasre	because
becuasxe	because
becuasz	because
becuasze	because
becuat	because
becuatse	because
becuau	because
becuause	because
becuav	because
becuavse	because
becuaw	because
becuawse	because
becuax	because
becuaxse	because
becuaz	because
becuazse	because
becuce	because
becucse	because
becude	because
becudse	because
becuease	because
becuee	because
becueese	because
becuese	because
becufe	because
becufse	because
becuge	because
becugse	because
becuhe	because
becuhse	because
becuie	because
becuise	because
becuje	because
becujse	because
becuke	because
becukse	because
becule	because
becume	because
becumse	because
becune	because
becunse	because
becuoe	because
becuose	because
becupe	because
becupse	because
becuqe	because
becuqse	because
becure	because
becurse	because
becus	because
becusae	because
becuscause	because
becusd	because
becusde	because
becusea	because
becusee	because
becusef	because
becuseh	because
becuseif	because if
becuseof	because of
becuses	because
becusew	because
becush	because
becushe	because
becusme	because
becusr	because
becusre	because
becuss	because
becusse	because
becusue	because
becusw	because
becusxe	because
becusz	because
becusze	because
becut	because
becute	because
becutse	because
becuve	because
becuvse	because
becuwe	because
becuwse	because
becuxe	because
becuxse	because
becuye	because
becuyse	because
becuze	because
becuzse	because
becvame	became
becvause	because
becwame	became
becwause	because
becxame	became
becxause	because
becxuse	because
becyame	became
becyause	because
becyse	because
becyuse	because
beczause	because
becztam	because
beczuse	because
bedacause	because
bedame	became
bedause	because
bedbause	because
bedcame	became
bedcause	because
beddcause	because
bedeause	because
bedefcause	because
bedezuse	because
bedfause	because
bedgcause	because
bedhause	because
bedieve	believe
bedin	begin
bedlam	bedlam
bedouse	because
bedridden	bedridden
bedrocck	bedrock
bedrooom	bedroom
bedrrom	bedroom
bedrum	bedroom
bedsause	because
bedtause	because
beduase	because
beducause	because
beduin	Bedouin
beduins	Bedouins
beduse	because
bedvause	because
bedwause	because
bedxause	because
bedyause	because
bedzause	because
bee	be
beecause	because
beechause	because
beecme	became
beecuse	because
beed	need
beefore	before
beefy	beefy
beegin	begin
beehause	because
beehive	beehive
beeieve	believe
beein	begin
beeinnging	beginning
beekeeper	beekeeper
beekeepers	beekeepers
beel	feel
beelause	because
beeleive	believe
beelieve	believe
beeline	beeline
beem	seem
beemcause	because
beenause	because
beengause	because
beeoming	becoming
beep	keep
beepe	beep
beerause	because
beercause	because
beerkause	because
beerlause	because
beersause	because
beertause	because
beesause	because
beesness	business
beethause	because
beethovan	Beethoven
beetlejuice	Beetlejuice
beetroot	beetroot
beets	beets
beeuase	because
beeucause	because
beevause	because
beevuse	because
beewause	because
beexause	because
beexuse	because
beeyause	because
beezause	because
beezuse	because
befacause	because
befame	became
befcame	became
befcause	because
befdame	became
befdause	because
befeause	because
befecause	because
befefcause	because
befere	before
beffe	beef
beffore	before
befgause	because
befhause	because
befieve	believe
befifit	benefit
befin	begin
befive	before
beflause	because
befmause	because
befnause	because
befoer	before
befoir	before
befoore	before
befor	before
beforee	before
beforehand	beforehand
beforew	before
beforn	before
beforre	before
befort	before
befour	before
befoure	before
befoyre	before
befrause	because
befre	before
befrend	befriend
befroe	before
befsause	because
beftause	because
befuase	because
befucause	because
befuddle	befuddle
befuddled	befuddled
befuddlement	befuddlement
befure	before
befvause	because
befwause	because
befxause	because
befyause	because
befzause	because
begacause	because
begame	became
began	begin
begat	begat
begause	because
begbn	begin
begcame	became
begcause	because
begcn	begin
begdause	because
begdn	begin
begeause	because
begehause	because
begen	begin
beget	beget
begeting	begetting
begfause	because
begfn	begin
beggar	beggar
beggared	beggared
beggarred	beggared
beggars	beggars
begged	begged
begger	beggar
beggers	beggars
beggin	begin
begginer	beginner
begging	begging
begginig	beginning
beggining	beginning
begginings	beginnings
begginner	beginner
begginning	beginning
begginnings	beginnings
beggins	begins
beggn	begin
beghause	because
beghn	begin
begi	begin
begia	begin
begian	began
begianing	beginning
begib	begin
begic	begin
begid	begin
begie	begin
begien	begin
begieve	believe
begif	begin
begig	begin
begih	begin
begii	begin
begiin	begin
begiinning	beginning
begij	begin
begijnning	beginning
begik	begin
begikn	begin
begil	begin
begilause	because
begim	begin
begimning	beginning
begimnings	beginnings
begims	begins
beging	begin
beginig	beginning
beginin	beginning
begining	beginning
beginings	beginnings
begininings	beginnings
beginn	begin
beginner	beginner
beginners	beginners
beginnes	begins
beginng	beginning
beginnig	beginning
beginnign	beginning
beginnigs	beginnings
beginniing	beginning
beginnin	beginning
beginnind	beginning
beginninf	beginning
beginninfs	beginnings
beginningg	beginning
beginninggs	beginnings
beginninh	beginning
beginninhs	beginnings
beginnink	beginning
beginninngs	beginnings
beginninsg	beginnings
beginnint	beginning
beginnning	beginning
beginnong	beginning
beginns	begins
beginnthe	begin the
beginsn	begins
beginsthe	begins the
begio	begin
begion	begin
begios	begins
begip	begin
begiq	begin
begir	begin
begis	begin
begit	begin
begiu	begin
begiun	begun
begiv	begin
begiw	begin
begix	begin
begiy	begin
begiz	begin
begjn	begin
begkn	begin
begknning	beginning
beglause	because
beglin	begin
begln	begin
begmause	because
begmn	begin
begn	begin
begnause	because
begndause	because
begneause	because
begnfause	because
begngause	because
begnhause	because
begni	begin
begnings	beginnings
begnjause	because
begnkause	because
begnlause	because
begnmause	because
begnn	begin
begnnause	because
begnoause	because
begnpause	because
begnqause	because
begnrause	because
begnsause	because
begntause	because
begnuause	because
begnvause	because
begnwause	because
begnxause	because
begnyause	because
begnzause	because
begon	begun
begone	begone
begot	begot
begotten	begotten
begouse	because
begpn	begin
begqn	begin
begramming	programming
begravate	aggravate
begrn	begin
begrude	begrudge
begrudge	begrudge
begrudgingly	begrudgingly
begs	begs
begse	because
begsn	begin
begtause	because
begtn	begin
beguase	because
begucause	because
beguile	beguile
beguilement	beguilement
beguilling	beguiling
beguime	beguile
beguinning	beginning
begum	begum
begume	became
begun	begun
beguse	because
begvause	because
begvn	begin
begwan	began
begwause	because
begwn	begin
begxause	because
begxn	begin
begyause	because
begyn	begin
begynning	beginning
begzause	because
begzn	begin
behacause	because
behacviour	behaviour
behaev	behave
behaeved	behaved
behaeving	behaving
behaevior	behavior
behaeviour	behaviour
behaifor	behavior
behaior	behavior
behalf	behalf
behame	became
behause	because
behavarism	behaviorism
behavaristic	behavioristic
behavaristically	behavioristically
behaveer	behavior
behaverism	behaviorism
behavers	behaviors
behaveur	behavior
behavevior	behavior
behaviarism	behaviorism
behaviaristic	behavioristic
behaviaristically	behavioristically
behavioir	behavior
behavioism	behaviorism
behavioistic	behavioristic
behavioistically	behavioristically
behavioor	behavior
behavior	behavior
behaviora	behavioral
behavioraal	behavioral
behaviorais	behavioral
behavioralism	behaviorism
behavioraly	behavioral
behavioras	behaviors
behaviorism	behaviorism
behaviorisrm	behaviorism
behavioristic	behavioristic
behavioristically	behavioristically
behaviorium	behavior
behaviorization	behavior
behaviorm	behavior
behaviornous	behaviorism
behaviorr	behavior
behaviorrs	behaviors
behaviors	behaviors
behavious	behavior
behavir	behavior
behavirer	behavior
behaviro	behavior
behavirr	behavior
behavirs	behaviors
behaviuor	behavior
behaviur	behavior
behavoior	behavior
behavoiur	behaviour
behavor	behavior
behavour	behaviour
behavrior	behavior
behavvior	behavior
behavviour	behaviour
behawvior	behavior
behayvior	behavior
behcause	because
beheaded	beheaded
beheadings	beheadings
beheasve	behave
beheavor	behavior
beheavour	behaviour
behecause	because
beheind	behind
beheivior	behavior
behemot	behemoth
behemoth	behemoth
behest	behest
behevior	behavior
beheviour	behaviour
behfause	because
behhause	because
behidn	behind
behiend	behind
behieve	believe
behieving	believing
behihd	behind
behiind	behind
behiknd	behind
behimd	behind
behimnd	behind
behin	begin
behinbd	behind
behinc	behind
behincd	behind
behince	behind
behincf	behind
behincg	behind
behinch	behind
behincs	behind
behincv	behind
behindd	behind
behindhand	behindhand
behindness	behindedness
behindp	behind
behindr	behind
behindt	behind
behinfd	behind
behingd	behind
behinhd	behind
behinid	behind
behinjd	behind
behinkd	behind
behinld	behind
behinmd	behind
behinnd	behind
behinod	behind
behinpd	behind
behinrd	behind
behinsd	behind
behintd	behind
behinud	behind
behinwd	behind
behinxd	behind
behinyd	behind
behinzd	behind
behiond	behind
behiund	behind
behivior	behavior
behiviour	behaviour
behjause	because
behkause	because
behlause	because
behlind	behind
behmause	because
behnause	because
behoave	behave
behond	behind
behoove	behoove
behooved	behooved
behooveful	behooveful
behooves	behooves
behooving	behooving
behorsed	be horsed
behourse	because
behoved	behoved
behovely	behooveful
behoves	behoves
behoving	behaving
behreause	because
behsause	because
behtause	because
behuase	because
behucause	because
behvavior	behavior
behvior	behavior
behviour	behaviour
behvoire	behavior
behvuse	because
behwause	because
behxause	because
behyause	because
behynd	behind
behyond	beyond
behzause	because
beicause	because
beiege	besiege
beieve	believe
beifast	Belfast
beigecause	because
beiginning	beginning
beign	begin
beigon	begin
beiieve	believe
beiieved	believed
beiif	belief
beiin	begin
beikng	being
beileve	believe
bein	begin
beind	being
beinds	beings
beine	being
beinefit	benefit
beinfg	being
beinfit	benefit
beinfits	benefits
beinfs	beings
being	bring
beingg	being
beingh	being
beingi	being
beingin	being in
beingings	beings
beingor	being or
beingt	being
beinng	being
beins	beings
beinsg	beings
beint	being
beintg	being
beinve	being
beirng	being
beiurt	beirut
beiveing	believing
bejacause	because
bejame	became
bejause	because
bejcame	became
bejcause	because
bejdause	because
bejeause	because
bejewel	bejewel
bejeweled	bejeweled
bejewelled	bejewelled
bejewelling	bejeweling
bejfause	because
bejhause	because
bejieve	believe
bejin	begin
bejing	Beijing
bejkause	because
bejlause	because
bejmause	because
bejnause	because
bejond	beyond
bejouse	because
bejrause	because
bejsause	because
bejtause	because
bejuase	because
bejucause	because
bejuse	because
bejvause	because
bejwause	because
bejxause	because
bejyause	because
bejzause	because
bekacause	because
bekame	became
bekause	because
bekcause	because
bekdause	because
bekeause	because
bekfause	because
bekhause	because
bekieve	believe
bekin	begin
bekind	behind
bekjause	because
bekkause	because
beklause	because
bekmause	because
beknause	because
bekome	become
bekouse	because
bekrause	because
beksause	because
bektause	because
bekuase	because
bekucause	because
bekuse	because
bekvause	because
bekwause	because
bekxause	because
bekyause	because
bekzause	because
belacause	because
belaeve	believe
belagerring	besieging
belaguered	beleaguered
belame	became
belapuse	because
belarus	Belarus
belarussian	Belarusian
belatadly	belatedly
belatdely	belatedly
belaud	be loud
belause	because
belbeve	believe
belcause	because
belceve	believe
belcium	Belgium
beldause	because
beldeve	believe
beleagoured	beleaguered
beleaguer	beleaguer
beleaguerd	beleaguered
beleaguered	beleaguered
beleagure	beleaguer
beleagured	beleaguered
beleauguered	beleaguered
belecause	because
beleef	belief
beleefs	beliefs
beleevable	believable
beleeve	believe
beleeved	believed
beleever	believer
beleevers	believers
beleeves	believes
beleeving	believing
beleficent	beneficent
beleiable	believable
beleif	belief
beleife	belief
beleifs	beliefs
beleive	believe
beleived	believed
beleiver	believer
beleives	believes
beleiving	believing
beleivs	believes
belender	blender
belerous	bellicose
belevan	believing
beleve	believe
beleved	believed
beleveing	believing
belevelent	benevolent
beleverable	believable
belevere	believer
belevers	believers
beleves	believes
belevible	believable
beleving	believing
belevs	believes
belfast	Belfast
belfasts	Belfast's
belfause	because
belfaust	Belfast
belfeve	believe
belfry	belfry
belgarade	Belgrade
belgarum	Belgium
belgeve	believe
belgiam	Belgium
belgian	Belgian
belgica	Belgium
belgien	Belgian
belgiens	Belgians
belgique	Belgium
belgiua	Belgium
belgiuam	Belgium
belgiuem	Belgium
belgiumm	Belgium
belgiun	Belgium
belgiuum	Belgium
belgradde	Belgrade
belguim	Belgium
belguium	Belgium
belgurae	Belgrade
belhause	because
belheve	believe
beliavable	believable
beliavably	believably
beliave	believe
belibve	believe
belicose	bellicose
belicous	bellicose
belicve	believe
belidve	believe
belieae	believe
beliebablely	believably
beliebably	believably
beliebale	believable
beliebaly	believably
beliebe	believe
beliebed	believed
belieber	believer
beliebers	believers
beliebes	believes
beliebing	believing
beliecause	because
beliece	believe
belieced	believed
belieces	believes
beliee	believe
belieee	believe
belieev	believe
belieeve	believe
beliefe	believe
beliege	believe
beliehe	believe
belieie	believe
belieje	believe
belieke	believe
beliele	believe
belieme	believe
beliene	believe
belieoe	believe
beliepe	believe
belieqe	believe
beliere	believe
beliese	believe
beliete	believe
belieue	believe
believ	believe
believa	believe
believabe	believable
believabely	believably
believable	believable
believablly	believably
believablw	believable
believabpy	believably
believaby	believably
believae	believe
believaed	believed
believaes	believes
believale	believable
believaly	believably
believanle	believable
believas	believes
believb	believe
believc	believe
believd	believed
believeable	believable
believeabley	believably
believeably	believably
believee	believe
believeed	believed
believeing	believing
believeingly	believingly
believel	believe
believels	believes
believemy	believe my
believen	believe
believeng	believing
believeor	believer
believer	believer
believerr	believer
believers	believers
believerss	believers
believes	believes
believf	believe
believfs	believes
believg	believe
believh	believe
believi	believe
believinbg	believing
believing	believing
believingly	believingly
believinng	believing
believity	believability
believj	believe
believk	believe
believl	believe
believm	believe
believn	believe
believo	believe
believp	believe
believr	believe
believs	believes
believt	believe
believu	believe
believv	believe
believve	believe
believw	believe
believx	believe
believy	believe
believz	believe
beliew	believe
beliewe	believe
beliexe	believe
belieye	believe
belieze	believe
belif	belief
belife	belief
belifes	beliefs
belifve	believe
beligerant	belligerent
beligerent	belligerent
beliguim	Belgium
beligve	believe
belihve	believe
beliieve	believe
beliieved	believed
beliiever	believer
beliif	belief
beliis	beliefs
beliive	believe
belijve	believe
belikve	believe
belilve	believe
belimve	believe
belin	begin
belineve	believe
belinve	believe
beliove	believe
belipve	believe
beliqve	believe
belirve	believe
belissae	bellicose
belisve	believe
belitles	belittles
belitling	belittling
belitteld	belittled
belitteling	belittling
belitting	belittling
belittled	belittled
belittlement	belittlement
belitve	believe
beliuve	believe
belivaable	believable
belive	believe
belived	believed
belivee	believe
beliveing	believing
beliver	believer
belivers	believers
belives	believes
beliving	believing
belivs	believes
belivve	believe
beliws	beliefs
beliwve	believe
belixve	believe
beliyve	believe
belizve	believe
beljause	because
beljeve	believe
belkause	because
belkeve	believe
bell	tell
bellcose	bellicose
belleaguered	beleaguered
belleif	belief
belleive	believe
bellephron	Bellerophon
bellergent	belligerent
belleve	believe
belleza	belleza
bellfry	belfry
bellgerant	belligerent
bellgerent	belligerent
bellicoce	bellicose
bellicoe	bellicose
bellicoseness	bellicosity
bellicosuty	bellicosity
bellicouse	bellicose
bellicowse	bellicose
belliderance	belligerence
bellidgerent	belligerent
belliefes	beliefs
belliefs	beliefs
belliegerance	belligerence
belliegerancy	belligerency
belliegerant	belligerent
belliegerants	belligerents
belliegerence	belligerence
belliegerency	belligerency
belliegerent	belligerent
belliegerents	belligerents
belliegrancy	belligerency
belliegrency	belligerency
belliegrent	belligerent
belliegrents	belligerents
bellieve	believe
bellifarant	belligerent
belligan	Belgian
belligarance	belligerance
belligarancy	belligerancy
belligarant	belligerent
belligarantly	belligerently
belligarants	belligerents
belligarence	belligerence
belligarency	belligerency
belligarent	belligerent
belligarently	belligerently
belligarents	belligerents
belligarious	belligerent
belligarncy	belligerency
belligarnt	belligerent
belligarnts	belligerents
belligeance	belligerence
belligearance	belligerence
belligearant	belligerent
belligearence	belligerence
belligearent	belligerent
belligearents	belligerents
belligearnce	belligerence
belligearncy	belligerency
belligeence	belligerence
belligeency	belligerency
belligegent	belligerent
belligence	belligerence
belligency	belligerency
belligerance	belligerence
belligerancy	belligerency
belligeranly	belligerently
belligeransy	belligerency
belligerants	belligerents
belligeranty	belligerently
belligerany	belligerency
belligerarnce	belligerence
belligerence	belligerence
belligerencey	belligerency
belligerency	belligerency
belligerens	belligerents
belligerent	belligerent
belligerenty	belligerently
belligerentyl	belligerently
belligeretnly	belligerently
belligerience	belligerence
belligernat	belligerent
belligernce	belligerence
belligerncy	belligerency
belligernece	belligerence
belligernet	belligerent
belligernety	belligerency
belligernt	belligerent
belliggrent	belligerent
belligrance	belligerence
belligrancy	belligerency
belligrant	belligerent
belligrants	belligerents
belligrency	belligerency
belligrent	belligerent
belligrents	belligerents
belliigence	belligerence
belliigent	belligerent
bellious	bellicose
bellis	bellies
belllicose	bellicose
bellligerent	belligerent
bellllicose	bellicose
bellllligerent	belligerent
belloc	Belloc
bellringers	bellringers
belltower	bell tower
belluim	Belgium
bellweather	bellwether
bellyause	because
bellyfull	bellyful
bellylaughs	belly laughs
belmause	because
belmeve	believe
belnause	because
belneve	believe
beloause	because
beloeve	believe
belogn	belong
belogned	belonged
belogning	belonging
belogs	belongs
belond	belong
beloned	belonged
belong	belong
belongd	belonged
belongging	belonging
belongiing	belonging
belongin	belonging
belongiong	belonging
belongng	belonging
belongnig	belonging
belongning	belonging
belongoing	belonging
belongong	belonging
belongss	belongs
belongsto	belongs to
beloning	belonging
belonog	belong
belons	belongs
belont	belong
beloof	belief
belove	below
beloved	beloved
belowe	below
beloze	below
belp	help
belpeve	believe
belpuse	because
belqeve	believe
belrause	because
belreve	believe
belsause	because
belseve	believe
belte	belt
belted	belted
belteve	believe
beltfed	belt-fed
beltline	beltline
beltway	beltway
beltways	beltways
beltwayt	beltway
belucause	because
belueve	believe
beluga	beluga
belugas	belugas
beluge	beluga
belung	belong
beluse	because
belvadere	belvedere
belvause	because
belvedeer	belvedere
belverdere	belvedere
belveve	believe
belvuse	because
belwause	because
belweve	believe
belxause	because
belxeve	believe
belyause	because
belyeve	believe
belzause	because
belzeve	believe
bemacause	because
bemame	became
bemause	because
bembause	because
bemcame	became
bemcause	because
bemdause	because
bemeause	because
bemember	remember
bemfause	because
bemhause	because
bemieve	believe
bemin	begin
bemjause	because
bemkause	because
bemlause	because
bemmause	because
bemnause	because
bemoan	bemoan
bemoaned	bemoaned
bemoaning	bemoaning
bemoans	bemoans
bemouse	because
bemrause	because
bemsause	because
bemtause	because
bemuase	because
bemucause	because
bemuse	bemuse
bemused	bemused
bemusement	bemusement
bemusing	bemusing
bemust	bemused
bemvause	because
bemwause	because
bemxause	because
bemyause	because
bemzause	because
benacause	because
benad	been had
benafficial	beneficial
benam	began
benamed	became
benami	began
benan	began
benaqe	became
benasue	because
benause	because
benazir	Benazir
benbeause	because
benbecause	because
benbfause	because
benbhause	because
benblause	because
benbnause	because
benbrause	because
benbvause	because
benbwause	because
benbxause	because
benbzause	because
bencame	became
bencar	began
bencause	because
benchamrk	benchmark
benchmar	benchmark
benchwarmers	bench warmers
bendause	because
bendeause	because
bendecause	because
bendedecause	because
bendefcause	because
bendfause	because
bendgause	because
bendgcause	because
bendhause	because
bendication	benediction
bendicktion	benediction
bendkause	because
bendlause	because
bendmause	because
bendnause	because
bendrause	because
bendsause	because
bendtause	because
benducause	because
bendvause	because
bendwause	because
bendxause	because
bendyause	because
bendzause	because
beneacause	because
beneame	became
beneash	beneath
beneaste	because
beneasus	because
beneatch	beneath
beneaths	beneath
beneause	because
benebause	because
benec	beneath
benecause	because
benece	because
benecfause	because
benector	benefactor
benedcause	because
benedicktion	benediction
benediet	benedict
benefacial	beneficial
benefacially	beneficially
benefacor	benefactor
benefactir	benefactor
benefactor	benefactor
benefactrors	benefactors
benefcial	beneficial
benefciaries	beneficiaries
benefciary	beneficiary
benefcient	beneficent
benefcit	benefit
benefcited	benefited
benefciting	benefiting
benefcits	benefits
benefecence	beneficence
benefecent	beneficent
benefecial	beneficial
benefeciaries	beneficiaries
benefeciary	beneficiary
benefecit	benefit
benefecited	benefited
benefeciting	benefiting
benefecits	benefits
benefet	benefit
benefeted	benefited
benefeting	benefiting
benefets	benefits
benefial	beneficial
benefiaries	beneficiaries
benefiary	beneficiary
benefical	beneficial
benefically	beneficially
beneficarie	beneficiary
beneficary	beneficiary
beneficas	beneficiaries
benefice	benefit
beneficeary	beneficiary
beneficed	benefited
beneficence	beneficence
beneficencee	beneficence
beneficenct	beneficent
beneficenet	beneficent
beneficenr	beneficent
beneficent	beneficent
beneficentr	beneficent
beneficents	beneficence
beneficenty	beneficent
benefices	benefits
beneficet	beneficent
beneficiaal	beneficial
beneficiaaly	beneficially
beneficiai	beneficial
beneficiairies	beneficiaries
beneficiairy	beneficiary
beneficiak	beneficial
beneficiakl	beneficial
beneficially	beneficially
beneficials	beneficiaries
beneficialy	beneficially
beneficialyl	beneficially
beneficiam	beneficial
beneficiaml	beneficial
beneficiams	beneficially
beneficiar	beneficiary
beneficiares	beneficiaries
beneficiarias	beneficiaries
beneficiarie	beneficiary
beneficiario	beneficiary
beneficiaris	beneficiaries
beneficiariy	beneficiary
beneficiarl	beneficial
beneficiarry	beneficiary
beneficiars	beneficiaries
beneficiart	beneficiary
beneficiarty	beneficiary
beneficiaruy	beneficiary
beneficiarys	beneficiaries
beneficiaryy	beneficiary
beneficias	beneficiaries
beneficiat	beneficiary
beneficiatie	beneficiaries
beneficiatis	beneficiaries
beneficiaty	beneficiary
beneficiatye	beneficiary
beneficiay	beneficiary
beneficiays	beneficiaries
beneficie	benefit
beneficieal	beneficial
beneficielly	beneficially
beneficience	beneficence
beneficienet	beneficent
beneficiens	beneficence
beneficient	beneficent
beneficienty	beneficent
beneficier	beneficiary
beneficieries	beneficiaries
beneficiers	beneficiaries
beneficiery	beneficiary
beneficies	beneficiaries
beneficiet	beneficent
beneficif	beneficial
beneficiial	beneficial
beneficiis	beneficiaries
beneficiit	benefit
beneficiites	benefits
beneficik	beneficial
beneficil	beneficial
beneficim	beneficial
beneficin	beneficial
beneficio	beneficial
beneficioes	beneficiaries
beneficioi	beneficial
beneficioj	beneficial
beneficiol	beneficial
beneficione	beneficence
beneficionet	beneficent
beneficios	beneficiaries
beneficioss	beneficiaries
beneficiot	beneficiary
beneficioty	beneficiary
beneficiral	beneficial
beneficiries	beneficiaries
beneficiry	beneficiary
beneficisl	beneficial
beneficitary	beneficiary
beneficiu	beneficial
beneficiual	beneficial
beneficiun	beneficial
benefickal	beneficial
benefickaries	beneficiaries
benefickary	beneficiary
beneficl	beneficial
beneficla	beneficial
beneficlly	beneficially
beneficne	beneficence
beneficnet	beneficent
beneficoal	beneficial
beneficol	beneficial
beneficries	beneficiaries
beneficry	beneficiary
benefidal	beneficial
benefidaries	beneficiaries
benefidary	beneficiary
benefie	benefit
benefiec	beneficent
benefiecal	beneficial
benefiecaries	beneficiaries
benefiecary	beneficiary
benefieced	beneficent
benefiecence	beneficence
benefiecent	beneficent
benefieciaal	beneficial
benefieciakl	beneficial
benefiecial	beneficial
benefieciall	beneficial
benefieciallly	beneficially
benefiecially	beneficially
benefiecialy	beneficially
benefiecialyl	beneficially
benefieciaries	beneficiaries
benefieciary	beneficiary
benefiecience	beneficence
benefiecient	beneficent
benefieciial	beneficial
benefiecil	beneficial
benefiecries	beneficiaries
benefiecry	beneficiary
benefiectal	beneficial
benefiectaries	beneficiaries
benefiectary	beneficiary
benefiecthe	beneficent
benefied	benefited
benefieds	benefited
benefience	beneficence
benefiencet	beneficent
benefienct	beneficent
benefienet	beneficent
benefienr	beneficent
benefient	beneficent
benefientest	beneficent
benefienty	beneficent
benefier	benefactor
benefies	benefits
benefiet	benefit
benefieted	benefited
benefieting	benefiting
benefiets	benefits
benefiews	benefits
benefifial	beneficial
benefigial	beneficial
benefihial	beneficial
benefiial	beneficial
benefiiaries	beneficiaries
benefiiary	beneficiary
benefiical	beneficial
benefiicaries	beneficiaries
benefiicary	beneficiary
benefiicent	beneficent
benefiicial	beneficial
benefiicially	beneficially
benefiiciaries	beneficiaries
benefiiciary	beneficiary
benefiience	beneficence
benefiient	beneficent
benefiies	beneficiaries
benefiiet	benefit
benefiiets	benefits
benefiil	beneficial
benefiinaries	beneficiaries
benefiinary	beneficiary
benefiiral	beneficial
benefiit	benefit
benefiited	benefited
benefiitee	beneficiary
benefiites	benefits
benefiiting	benefiting
benefiits	benefits
benefiitted	benefited
benefiitting	benefiting
benefijial	beneficial
benefikial	beneficial
benefil	beneficial
benefiliaries	beneficiaries
benefiliary	beneficiary
benefioal	beneficial
benefiocial	beneficial
benefir	benefit
benefiral	beneficial
benefiraries	beneficiaries
benefirary	beneficiary
benefirce	beneficence
benefircent	beneficent
benefirearies	beneficiaries
benefireary	beneficiary
benefirs	benefits
benefis	benefits
benefishal	beneficial
benefisial	beneficial
benefisially	beneficially
benefisiance	beneficence
benefisiant	beneficent
benefisiaries	beneficiaries
benefisiary	beneficiary
benefisience	beneficence
benefisient	beneficent
benefisil	beneficial
benefist	benefit
benefisted	benefited
benefisting	benefiting
benefists	benefits
benefit	benefit
benefitaries	beneficiaries
benefitay	beneficiary
benefite	benefit
benefitearies	beneficiaries
benefiteary	beneficiary
benefitecial	beneficial
benefitecially	beneficially
benefited	benefited
benefiteed	benefited
benefiteial	beneficial
benefiteies	beneficiaries
benefitence	beneficence
benefitences	beneficence
benefitenct	beneficent
benefitent	beneficent
benefiter	benefactor
benefiters	benefactors
benefites	benefits
benefitet	benefit
benefitfactor	benefactor
benefitial	beneficial
benefitialal	beneficial
benefitially	beneficially
benefitialy	beneficially
benefitiancial	beneficial
benefitiaries	beneficiaries
benefitiary	beneficiary
benefitice	benefit
benefiticence	beneficence
benefiticent	beneficent
benefiticiaal	beneficial
benefiticiall	beneficial
benefiticially	beneficially
benefiticialy	beneficially
benefiticiaries	beneficiaries
benefiticiary	beneficiary
benefiticious	beneficent
benefitied	benefited
benefities	benefits
benefitiial	beneficial
benefiting	benefiting
benefitiong	benefiting
benefitior	beneficiary
benefitiors	beneficiaries
benefititious	beneficent
benefitness	beneficence
benefito	benefit
benefitoal	beneficial
benefitoral	beneficial
benefitoraries	beneficiaries
benefitorary	beneficiary
benefitories	beneficiaries
benefitors	benefactors
benefitory	beneficiary
benefitous	beneficent
benefitraries	beneficiaries
benefitrary	beneficiary
benefitred	benefited
benefitres	benefits
benefitrial	beneficial
benefits	benefits
benefitsd	benefits
benefitt	benefit
benefittaries	beneficiaries
benefittary	beneficiary
benefitte	benefit
benefitted	benefited
benefitteed	benefited
benefittes	benefits
benefittficial	beneficial
benefittial	beneficial
benefitting	benefiting
benefittories	beneficiaries
benefittory	beneficiary
benefittred	benefited
benefitts	benefits
benefitus	benefits
benefity	benefit
benefityr	beneficiary
benefius	benefits
benefivial	beneficial
benefiyt	benefit
benefiyted	benefited
benefiyting	benefiting
benefiyts	benefits
benefo	benefit
benefocal	beneficial
benefocaries	beneficiaries
benefocary	beneficiary
benefoce	beneficence
benefocence	beneficence
benefocent	beneficent
benefocial	beneficial
benefocially	beneficially
benefociance	beneficence
benefociant	beneficent
benefociaries	beneficiaries
benefociary	beneficiary
benefocience	beneficence
benefocient	beneficent
benefocil	beneficial
benefocirial	beneficial
benefociries	beneficiaries
benefociry	beneficiary
benefocries	beneficiaries
benefocry	beneficiary
benefoctal	beneficial
benefoctaries	beneficiaries
benefoctary	beneficiary
benefocto	benefactor
benefoctories	beneficiaries
benefoctory	beneficiary
benefocy	beneficiary
benefoed	benefited
benefoes	benefits
benefoing	benefiting
benefor	benefactor
benefored	benefited
benefores	benefits
beneforing	benefiting
benefot	benefit
benefoted	benefited
benefoting	benefiting
benefotries	beneficiaries
benefotry	beneficiary
benefots	benefits
benefricial	beneficial
benefriciaries	beneficiaries
benefriciary	beneficiary
benefrit	benefit
benefrited	benefited
benefriting	benefiting
benefrits	benefits
benefrts	benefits
benefsial	beneficial
benefsially	beneficially
benefsiaries	beneficiaries
benefsiary	beneficiary
benefsically	beneficially
benefsicence	beneficence
benefsicent	beneficent
benefsience	beneficence
benefsient	beneficent
benefsit	benefit
benefsited	benefited
benefsiting	benefiting
benefsits	benefits
benefsitting	benefiting
benefstial	beneficial
benefstiaries	beneficiaries
benefstiary	beneficiary
benefstical	beneficial
benefstically	beneficially
benefstience	beneficence
benefstient	beneficent
benefsties	beneficiaries
benefstil	beneficial
benefstry	beneficiary
benefsts	benefits
benefstts	benefits
benefts	benefits
beneftt	benefit
benefuarse	beneficiaries
benefuase	because
benefucause	because
benefucial	beneficial
benefuciall	beneficial
benefuciallly	beneficially
benefucially	beneficially
benefucialy	beneficially
benefucialyl	beneficially
benefuciaries	beneficiaries
benefuciary	beneficiary
benefucience	beneficence
benefucient	beneficent
benefucil	beneficial
benefucries	beneficiaries
benefucry	beneficiary
benefudal	beneficial
benefudaries	beneficiaries
benefudary	beneficiary
benefue	benefit
benefuecial	beneficial
benefues	benefits
benefuicial	beneficial
benefuies	beneficiaries
benefuire	beneficiary
benefuiries	beneficiaries
benefuiry	beneficiary
benefuit	benefit
benefuited	benefited
benefuiting	benefiting
benefuits	benefits
benefuitted	benefited
benefuitting	benefiting
beneful	beneficial
benefularies	beneficiaries
benefulary	beneficiary
benefulness	beneficence
benefurial	beneficial
benefurries	beneficiaries
benefurry	beneficiary
benefus	benefits
benefut	benefit
benefuted	benefited
benefutes	benefits
benefuting	benefiting
benefuts	benefits
benefututted	benefited
benefututting	benefiting
benefvacial	beneficial
benefvae	because
benefvause	because
benefvcial	beneficial
benefvcibutton	belly button
benefvicial	beneficial
benefviciaries	beneficiaries
benefviciary	beneficiary
benefvit	benefit
benefvited	benefited
benefviting	benefiting
benefvits	benefits
benefwicial	beneficial
benefwiciaries	beneficiaries
benefwiciary	beneficiary
benefwit	benefit
benefwited	benefited
benefwiting	benefiting
benefwits	benefits
benefxicial	beneficial
benefxiciaries	beneficiaries
benefxiciary	beneficiary
benefxit	benefit
benefxited	benefited
benefxiting	benefiting
benefxits	benefits
benefyicial	beneficial
benefyiciaries	beneficiaries
benefyiciary	beneficiary
benefyit	benefit
benefyited	benefited
benefyiting	benefiting
benefyits	benefits
benefzicial	beneficial
benefziciaries	beneficiaries
benefziciary	beneficiary
benefzit	benefit
benefzited	benefited
benefziting	benefiting
benefzits	benefits
benegause	because
benehause	because
beneign	benign
benekause	because
benelux	Benelux
beneme	became
benemfause	because
benemgause	because
benemhause	because
benemkause	because
benemlause	because
benemmause	because
benemnause	because
benemrause	because
benemsause	because
benemtause	because
benemvause	because
benemwause	because
benemxause	because
benemyause	because
benemzause	because
benenause	because
benendause	because
beneneause	because
benenfause	because
benengause	because
benenhause	because
benenjause	because
benenkause	because
benenlause	because
benenmause	because
benennause	because
benenrause	because
benensause	because
benentause	because
benenvause	because
benenwause	because
benenxause	because
benenyause	because
benenzause	because
beneolent	benevolent
benerause	because
benerdict	benedict
benieve	believe
benin	begin
beoieve	believe
beoin	begin
beople	people
bepieve	believe
bepin	begin
beqieve	believe
beqin	begin
berieve	believe
berin	begin
besieve	believe
besin	begin
bet	let
betieve	believe
betin	begin
beuieve	believe
beuin	begin
bevieve	believe
bevin	begin
bewieve	believe
bewin	begin
bexieve	believe
bexin	begin
beyieve	believe
beyin	begin
bezieve	believe
bezin	begin
bfgin	begin
bfing	bring
bflieve	believe
bft	but
bgein	begin
bggin	begin
bgin	begin
bging	bring
bglieve	believe
bgt	but
bhat	that
bhe	the
bhey	they
bhgin	begin
bhing	bring
bhis	this
bhlieve	believe
bhow	show
bht	but
bigin	begin
biing	bring
bilieve	believe
bill	will
bime	time
bind	find
bing	bring
birng	bring
bit	sit
bith	with
bive	live
bjgin	begin
bjing	bring
bjlieve	believe
bjt	but
bkgin	begin
bking	bring
bklieve	believe
bkt	but
blay	play
bleieve	believe
blgin	begin
blieve	believe
bling	bring
bllieve	believe
blt	but
bmgin	begin
bming	bring
bmlieve	believe
bmt	but
bnd	and
bngin	begin
bning	bring
bnlieve	believe
bnow	know
bnt	but
bogin	begin
boing	bring
bold	hold
bolieve	believe
bome	come
bood	good
book	look
bor	for
bork	work
bot	not
bou	you
bout	about
bove	move
bpgin	begin
bping	bring
bplieve	believe
bpt	but
bqgin	begin
bqing	bring
bqlieve	believe
bqt	but
brang	bring
brbng	bring
brcng	bring
brdng	bring
breng	bring
brfng	bring
brgin	begin
brgng	bring
brhng	bring
briag	bring
bribg	bring
bricg	bring
bridg	bring
brieg	bring
brifg	bring
brig	bring
brigg	bring
brign	bring
brihg	bring
briig	bring
briing	bring
brijg	bring
brikg	bring
brilg	bring
brimg	bring
brin	bring
brina	bring
brinb	bring
brinc	bring
brind	bring
brine	bring
brinf	bring
bringg	bring
brinh	bring
brini	bring
brinj	bring
brink	bring
brinl	bring
brinm	bring
brinn	bring
brinng	bring
brino	bring
brinp	bring
brinq	bring
brinr	bring
brins	bring
brint	bring
brinu	bring
brinv	bring
brinw	bring
brinx	bring
briny	bring
brinz	bring
briog	bring
bripg	bring
briqg	bring
brirg	bring
brisg	bring
brite	write
britg	bring
briug	bring
brivg	bring
briwg	bring
brixg	bring
briyg	bring
brizg	bring
brjng	bring
brkng	bring
brlieve	believe
brlng	bring
brmng	bring
brng	bring
brnig	bring
brnng	bring
brom	from
brong	bring
brovide	provide
brpng	bring
brqng	bring
brring	bring
brrng	bring
brsng	bring
brt	but
brtng	bring
brung	bring
brvng	bring
brwng	bring
brxng	bring
bry	try
bryng	bring
brzng	bring
bse	use
bsgin	begin
bsing	bring
bsk	ask
bslieve	believe
bst	but
bt	but
btart	start
btgin	begin
bther	other
bting	bring
btlieve	believe
btt	but
btu	but
btw	by the way
bu	but
bua	but
bub	but
buc	but
bud	but
bue	but
buf	but
bug	but
bugin	begin
buh	but
bui	but
buing	bring
buj	but
buk	but
bul	but
bulieve	believe
bum	but
bun	but
buo	but
bup	but
buq	but
bur	but
burn	turn
bus	but
but	put
butt	but
buu	but
buut	but
buv	but
buw	but
bux	but
buy	but
buz	but
bvgin	begin
bving	bring
bvlieve	believe
bvt	but
bwgin	begin
bwing	bring
bwlieve	believe
bwt	but
bxgin	begin
bxing	bring
bxlieve	believe
bxt	but
bygin	begin
bying	bring
bylieve	believe
byt	but
byy	by
bzgin	begin
bzing	bring
bzlieve	believe
bzt	but
caal	call
caall	call
cabl	call
cacl	call
cadl	call
cael	call
cafl	call
cagl	call
cahl	call
cail	call
cajl	call
cake	make
cakl	call
cal	call
cala	call
calb	call
calc	call
cald	call
cale	call
calf	call
calg	call
calh	call
cali	call
calj	call
calk	call
calll	call
calm	call
caln	call
calo	call
calp	call
calq	call
calr	call
cals	call
calt	call
calu	call
calv	call
calw	call
calx	call
caly	call
calz	call
came	come
caml	call
canl	call
cann	can
cant	can't
caol	call
capl	call
cappen	happen
caql	call
carl	call
casl	call
catl	call
caul	call
cave	have
cavl	call
cawl	call
caxl	call
cay	say
cayl	call
cazl	call
cbll	call
cbme	come
ccall	call
ccll	call
ccme	come
ccome	come
cdll	call
cdme	come
cear	year
ceave	leave
cee	see
ceed	need
ceel	feel
ceem	seem
ceep	keep
cegin	begin
celieve	believe
cell	tell
celp	help
ceme	come
ceople	people
cet	let
cfll	call
cfme	come
cgll	call
cgme	come
chat	that
che	the
chey	they
ching	thing
chis	this
chll	call
chme	come
chow	show
cill	will
cime	time
cind	find
cit	sit
cith	with
cive	give
cjll	call
cjme	come
ckll	call
ckme	come
clal	call
clay	play
cll	call
clll	call
clme	come
cme	come
cmll	call
cmme	come
cmoe	come
cnd	and
cnll	call
cnme	come
cnow	know
coae	come
cobe	come
coce	come
code	come
coe	come
coee	come
coem	come
cofe	come
coge	come
cohe	come
coie	come
coje	come
coke	come
cold	hold
cole	come
coll	call
com	come
coma	come
comb	come
comc	come
comd	come
comee	come
comf	come
comg	come
comh	come
comi	come
comj	come
comk	come
coml	come
comm	come
comme	come
comn	come
como	come
comp	come
comq	come
comr	come
coms	come
comt	come
comu	come
comv	come
comw	come
comx	come
comy	come
comz	come
cone	come
cood	good
cooe	come
cook	look
coome	come
cope	come
coqe	come
cor	for
core	come
cork	work
cose	come
cot	not
cote	come
cou	you
coue	come
couldd	could
cove	move
cowe	come
coxe	come
coye	come
coze	come
cpll	call
cpme	come
cqll	call
cqme	come
cring	bring
crite	write
crll	call
crme	come
crom	from
crovide	provide
cry	try
cse	use
csk	ask
csll	call
csme	come
ctart	start
cther	other
ctll	call
ctme	come
cull	call
cume	come
cun	run
curn	turn
cut	put
cvll	call
cvme	come
cwll	call
cwme	come
cxll	call
cxme	come
cyll	call
cyme	come
czll	call
czme	come
dake	make
dalk	talk
dall	call
dant	want
dappen	happen
dave	have
day	say
dear	hear
deave	leave
dee	see
deed	need
deel	feel
deem	seem
deep	keep
definately	definitely
degin	begin
delieve	believe
dell	tell
delp	help
deople	people
det	let
dhat	that
dhe	the
dhey	they
dhing	thing
dhis	this
dhow	show
dill	will
dime	time
dind	find
dit	sit
dith	with
dive	give
dl	would
dlay	play
dnd	and
dnow	know
dold	hold
dome	come
dont	don't
doo	do
dood	good
dook	look
dor	for
dork	work
dot	not
dou	you
dove	move
dring	bring
drite	write
drom	from
drovide	provide
dry	try
dse	use
dsk	ask
dtart	start
dther	other
dun	run
durn	turn
dut	but
eake	make
ealk	talk
eall	call
eant	want
eappen	happen
ear	year
eave	leave
eay	say
ebgin	begin
eblieve	believe
ee	see
eear	year
eeave	leave
eed	need
eee	see
eeed	need
eeel	feel
eeem	seem
eeep	keep
eegin	begin
eel	feel
eelieve	believe
eell	tell
eelp	help
eem	seem
eeople	people
eep	keep
eet	let
efel	feel
egin	begin
ehar	hear
ehat	that
ehe	the
ehey	they
ehing	thing
ehis	this
ehlp	help
ehow	show
eill	will
eime	time
eind	find
eit	sit
eith	with
eive	live
ek	make
ekep	keep
elave	leave
elay	play
elieve	believe
ell	tell
elp	people
elt	let
em	some
end	and
ened	need
enow	know
enviroment	environment
eold	hold
eome	come
eood	good
eook	look
eople	people
eor	for
eork	work
eot	not
eou	you
eove	move
epople	people
er	her
ering	bring
erite	write
erom	from
erovide	provide
ery	try
ese	see
esem	seem
esk	ask
et	get
etart	start
ether	other
etll	tell
eun	run
eurn	turn
eut	put
ev	have
excelent	excellent
eyar	year
fael	feel
fake	take
falk	talk
fall	call
fand	find
fant	want
faom	from
fappen	happen
far	for
fave	have
fay	say
fbel	feel
fbnd	find
fbom	from
fbr	for
fcel	feel
fcnd	find
fcom	from
fcr	for
fdel	feel
fdnd	find
fdom	from
fdr	for
feal	feel
fear	hear
feave	leave
febl	feel
fecl	feel
fedl	feel
fee	feel
feea	feel
feeb	feel
feec	feel
feed	need
feee	feel
feeel	feel
feef	feel
feeg	feel
feeh	feel
feei	feel
feej	feel
feek	feel
feell	feel
feem	feel
feen	feel
feeo	feel
feep	keep
feeq	feel
feer	feel
fees	feel
feet	feel
feeu	feel
feev	feel
feew	feel
feex	feel
feey	feel
feez	feel
fefl	feel
fegin	begin
fegl	feel
fehl	feel
feil	feel
fejl	feel
fekl	feel
fel	feel
fele	feel
felieve	believe
fell	feel
felp	help
feml	feel
fend	find
fenl	feel
feol	feel
feom	from
feople	people
fepl	feel
feql	feel
fer	for
ferl	feel
fesl	feel
fet	let
fetl	feel
feul	feel
fevl	feel
fewl	feel
fexl	feel
feyl	feel
fezl	feel
ffeel	feel
ffel	feel
ffind	find
ffnd	find
ffom	from
ffor	for
ffr	for
ffrom	from
fgel	feel
fgnd	find
fgom	from
fgr	for
fhat	that
fhe	the
fhel	feel
fhey	they
fhing	thing
fhis	this
fhnd	find
fhom	from
fhow	show
fhr	for
fiad	find
fibd	find
ficd	find
fid	find
fidd	find
fidn	find
fied	find
fiel	feel
fifd	find
figd	find
fihd	find
fiid	find
fiind	find
fijd	find
fikd	find
fild	find
fill	will
fimd	find
fime	time
fin	find
fina	find
finb	find
finc	find
findd	find
fine	find
finf	find
fing	find
finh	find
fini	find
finj	find
fink	find
finl	find
finm	find
finn	find
finnd	find
fino	find
finp	find
finq	find
finr	find
fins	find
fint	find
finu	find
finv	find
finw	find
finx	find
finy	find
finz	find
fiod	find
fiom	from
fipd	find
fiqd	find
fir	for
fird	find
fisd	find
fit	sit
fitd	find
fith	with
fiud	find
fivd	find
five	live
fiwd	find
fixd	find
fiyd	find
fizd	find
fjel	feel
fjnd	find
fjom	from
fjr	for
fkel	feel
fknd	find
fkom	from
fkr	for
flay	play
flel	feel
flnd	find
flom	from
flr	for
fmel	feel
fmnd	find
fmom	from
fmr	for
fnd	find
fnel	feel
fnid	find
fnnd	find
fnom	from
fnow	know
fnr	for
fo	for
foa	for
fob	for
foc	for
fod	for
foe	for
foel	feel
fof	for
fog	for
foh	for
foi	for
foj	for
fok	for
fol	for
fold	hold
fom	from
fome	come
fon	for
fond	find
foo	for
food	good
fook	look
foom	from
foor	for
fop	for
foq	for
fork	work
form	from
forr	for
fos	for
fot	for
fou	for
fov	for
fove	move
fow	for
fox	for
foy	for
foz	for
fpel	feel
fpnd	find
fpom	from
fpr	for
fqel	feel
fqnd	find
fqom	from
fqr	for
fr	for
fram	from
frbm	from
frcm	from
frdm	from
frel	feel
frem	from
frfm	from
frgm	from
frhm	from
frim	from
fring	bring
frite	write
frjm	from
frkm	from
frlm	from
frm	from
frmm	from
frmo	from
frnd	find
frnm	from
fro	for
froa	from
frob	from
froc	from
frod	from
froe	from
frof	from
frog	from
froh	from
froi	from
froj	from
frok	from
frol	from
fromm	from
fron	from
froo	from
froom	from
frop	from
froq	from
fror	from
fros	from
frot	from
frou	from
frov	from
frovide	provide
frow	from
frox	from
froy	from
froz	from
frpm	from
frqm	from
frr	for
frrm	from
frrom	from
frsm	from
frtm	from
frum	from
frvm	from
frwm	from
frxm	from
fry	try
frym	from
frzm	from
fse	use
fsel	feel
fsk	ask
fsnd	find
fsom	from
fsr	for
ftart	start
ftel	feel
fther	other
ftnd	find
ftom	from
ftr	for
fuel	feel
fun	run
fund	find
fuom	from
fur	for
furn	turn
fut	but
fvel	feel
fvnd	find
fvom	from
fvr	for
fwel	feel
fwnd	find
fwom	from
fwr	for
fxel	feel
fxnd	find
fxom	from
fxr	for
fyel	feel
fynd	find
fyom	from
fyr	for
fzel	feel
fznd	find
fzom	from
fzr	for
gake	take
galk	talk
gall	call
gant	want
gaod	good
gappen	happen
gave	have
gay	say
gbod	good
gbve	give
gcod	good
gcve	give
gdod	good
gdve	give
gear	hear
geave	leave
gee	see
geed	need
geel	feel
geem	seem
geep	keep
gegin	begin
gelieve	believe
gell	tell
gelp	help
geod	good
geople	people
get	let
gett	get
geve	give
gfod	good
gfve	give
ggive	give
ggod	good
ggood	good
ggve	give
ghat	that
ghe	the
ghey	they
ghing	thing
ghis	this
ghod	good
ghow	show
ghve	give
giae	give
gibe	give
gice	give
gide	give
gie	give
giee	give
giev	give
gife	give
gige	give
gihe	give
giie	give
giive	give
gije	give
gike	give
gile	give
gill	will
gime	give
gind	find
gine	give
giod	good
gioe	give
gipe	give
giqe	give
gire	give
gise	give
git	sit
gite	give
gith	with
giue	give
giv	give
giva	give
givb	give
givc	give
givd	give
give	live
givee	give
givf	give
givg	give
givh	give
givi	give
givj	give
givk	give
givl	give
givm	give
givn	give
givo	give
givp	give
givq	give
givr	give
givs	give
givt	give
givu	give
givv	give
givve	give
givw	give
givx	give
givy	give
givz	give
giwe	give
gixe	give
giye	give
gize	give
gjod	good
gjve	give
gkod	good
gkve	give
glay	play
glod	good
glve	give
gmod	good
gmve	give
gnd	and
gnod	good
gnow	know
gnve	give
goad	good
gobd	good
gocd	good
god	good
godd	good
godo	good
goed	good
gofd	good
gogd	good
gohd	good
goid	good
gojd	good
gokd	good
gold	good
gomd	good
gome	come
gond	good
gonna	going to
goo	go
gooa	good
goob	good
gooc	good
goodd	good
gooe	good
goof	good
goog	good
gooh	good
gooi	good
gooj	good
gook	good
gool	good
goom	good
goon	good
gooo	good
goood	good
goop	good
gooq	good
goor	good
goos	good
goot	good
goou	good
goov	good
goow	good
goox	good
gooy	good
gooz	good
gopd	good
goqd	good
gor	for
gord	good
gork	work
gosd	good
got	not
gotd	good
gotta	got to
gou	you
goud	good
govd	good
gove	give
gowd	good
goxd	good
goyd	good
gozd	good
gpod	good
gpve	give
gqod	good
gqve	give
gring	bring
grite	write
grod	good
grom	from
grovide	provide
grve	give
gry	try
gse	use
gsk	ask
gsod	good
gsve	give
gtart	start
gther	other
gtod	good
gtve	give
gun	run
guod	good
gurn	turn
gut	but
guve	give
gve	give
gvie	give
gvod	good
gvve	give
gwod	good
gwve	give
gxod	good
gxve	give
gyod	good
gyve	give
gzod	good
gzve	give
haae	have
haapen	happen
haappen	happen
haar	hear
haave	have
habe	have
habpen	happen
hace	have
hacpen	happen
hade	have
hadpen	happen
hae	have
haee	have
haepen	happen
haer	hear
haev	have
hafe	have
hafpen	happen
hage	have
hagpen	happen
hahe	have
hahpen	happen
haie	have
haipen	happen
haje	have
hajpen	happen
hake	have
hakpen	happen
hald	hold
hale	have
halk	talk
hall	call
halp	help
halpen	happen
hame	have
hampen	happen
hane	have
hanpen	happen
hant	want
haoe	have
haopen	happen
hapaen	happen
hapben	happen
hapcen	happen
hapden	happen
hape	have
hapeen	happen
hapen	happen
hapepn	happen
hapfen	happen
hapgen	happen
haphen	happen
hapien	happen
hapjen	happen
hapken	happen
haplen	happen
hapmen	happen
hapnen	happen
hapoen	happen
happan	happen
happbn	happen
happcn	happen
happdn	happen
happe	happen
happea	happen
happeb	happen
happec	happen
happed	happen
happee	happen
happeen	happen
happef	happen
happeg	happen
happeh	happen
happei	happen
happej	happen
happek	happen
happel	happen
happem	happen
happenn	happen
happeo	happen
happep	happen
happeq	happen
happer	happen
happes	happen
happet	happen
happeu	happen
happev	happen
happew	happen
happex	happen
happey	happen
happez	happen
happfn	happen
happgn	happen
happhn	happen
happin	happen
happjn	happen
happkn	happen
happln	happen
happmn	happen
happn	happen
happne	happen
happnn	happen
happon	happen
happpen	happen
happpn	happen
happqn	happen
happrn	happen
happsn	happen
happtn	happen
happun	happen
happvn	happen
happwn	happen
happxn	happen
happyn	happen
happzn	happen
hapqen	happen
hapren	happen
hapsen	happen
hapten	happen
hapuen	happen
hapven	happen
hapwen	happen
hapxen	happen
hapyen	happen
hapzen	happen
haqe	have
haqpen	happen
har	hear
hare	have
harpen	happen
hase	have
hasnt	hasn't
haspen	happen
hat	what
hate	have
haue	have
haupen	happen
hav	have
hava	have
havb	have
havc	have
havd	have
havee	have
havent	haven't
havf	have
havg	have
havh	have
havi	have
havj	have
havk	have
havl	have
havm	have
havn	have
havo	have
havp	have
havpen	happen
havq	have
havr	have
havs	have
havt	have
havu	have
havv	have
havve	have
havw	have
havx	have
havy	have
havz	have
hawe	have
hawpen	happen
haxe	have
haxpen	happen
hay	say
haye	have
haypen	happen
haze	have
hazpen	happen
hbar	hear
hbld	hold
hblp	help
hbppen	happen
hbve	have
hc	which
hcar	hear
hcld	hold
hclp	help
hcppen	happen
hcve	have
hdar	hear
hdld	hold
hdlp	help
hdppen	happen
hdve	have
he	she
hea	hear
heaa	hear
heaar	hear
heab	hear
heac	hear
head	hear
heae	hear
heaf	hear
heag	hear
heah	hear
heai	hear
heaj	hear
heak	hear
heal	hear
heam	hear
hean	hear
heao	hear
heap	help
heaq	hear
hear	year
hearr	hear
heas	hear
heat	hear
heau	hear
heav	hear
heave	leave
heaw	hear
heax	hear
heay	hear
heaz	hear
hebp	help
hebr	hear
hecp	help
hecr	hear
hedp	help
hedr	hear
hee	he
heear	hear
heed	need
heel	feel
heelp	help
heem	seem
heep	keep
heer	hear
hefp	help
hefr	hear
hegin	begin
hegp	help
hegr	hear
hehp	help
hehr	hear
heip	help
heir	their
hejp	help
hejr	hear
hekp	help
hekr	hear
hel	help
hela	help
helb	help
helc	help
held	hold
hele	help
helf	help
helg	help
helh	help
heli	help
helieve	believe
helj	help
helk	help
hell	tell
hellp	help
helm	help
heln	help
helo	help
helpp	help
helq	help
helr	hear
hels	help
helt	help
helu	help
helv	help
helw	help
helx	help
hely	help
helz	help
hem	them
hemp	help
hemr	hear
hen	when
henp	help
henr	hear
heop	help
heople	people
heor	hear
hep	help
hepl	help
hepp	help
heppen	happen
hepr	hear
heqp	help
heqr	hear
her	hear
hera	hear
here	there
herp	help
herr	her
hes	he's
hesp	help
hesr	hear
het	let
hetp	help
hetr	hear
heup	help
heur	hear
heve	have
hevp	help
hevr	hear
hewp	help
hewr	hear
hexp	help
hexr	hear
hey	they
heyp	help
heyr	hear
hezp	help
hezr	hear
hfar	hear
hfld	hold
hflp	help
hfppen	happen
hfve	have
hgar	hear
hgld	hold
hglp	help
hgppen	happen
hgve	have
hhappen	happen
hhar	hear
hhat	that
hhave	have
hhe	the
hhear	hear
hhelp	help
hhey	they
hhing	thing
hhis	this
hhld	hold
hhlp	help
hhold	hold
hhow	show
hhppen	happen
hhve	have
hiar	hear
hich	which
hild	hold
hill	will
hilp	help
hime	time
himm	him
hind	find
hing	thing
hippen	happen
his	this
hiss	his
hit	sit
hith	with
hive	live
hjar	hear
hjld	hold
hjlp	help
hjppen	happen
hjve	have
hkar	hear
hkld	hold
hklp	help
hkppen	happen
hkve	have
hlar	hear
hlay	play
hld	hold
hlep	help
hlld	hold
hllp	help
hlod	hold
hlp	help
hlppen	happen
hlve	have
hmar	hear
hmld	hold
hmlp	help
hmppen	happen
hmve	have
hnar	hear
hnd	and
hnld	hold
hnlp	help
hnow	know
hnppen	happen
hnve	have
ho	who
hoad	hold
hoar	hear
hobd	hold
hocd	hold
hod	hold
hodd	hold
hodl	hold
hoed	hold
hofd	hold
hogd	hold
hohd	hold
hoid	hold
hojd	hold
hokd	hold
hol	hold
hola	hold
holb	hold
holc	hold
holdd	hold
hole	hold
holf	hold
holg	hold
holh	hold
holi	hold
holj	hold
holk	hold
holl	hold
holld	hold
holm	hold
holn	hold
holo	hold
holp	hold
holq	hold
holr	hold
hols	hold
holt	hold
holu	hold
holv	hold
holw	hold
holx	hold
holy	hold
holz	hold
homd	hold
home	come
hond	hold
hood	hold
hook	look
hoold	hold
hopd	hold
hoppen	happen
hoqd	hold
hor	for
hord	hold
hork	work
hosd	hold
hot	not
hotd	hold
hou	you
houd	hold
hovd	hold
hove	have
how	show
howd	hold
hoxd	hold
hoyd	hold
hozd	hold
hpapen	happen
hpar	hear
hpld	hold
hplp	help
hppen	happen
hpppen	happen
hpve	have
hqar	hear
hqld	hold
hqlp	help
hqppen	happen
hqve	have
hrar	hear
hring	bring
hrite	write
hrld	hold
hrlp	help
hrom	from
hrovide	provide
hrppen	happen
hrve	have
hry	try
hsar	hear
hse	use
hsk	ask
hsld	hold
hslp	help
hsow	show
hsppen	happen
hsve	have
ht	with
htar	hear
htart	start
htat	that
hte	the
htey	they
hther	other
hting	thing
htis	this
htld	hold
htlp	help
htppen	happen
htve	have
huar	hear
huld	hold
hulp	help
hun	run
huppen	happen
hurn	turn
hut	put
huve	have
hvae	have
hvar	hear
hve	have
hvld	hold
hvlp	help
hvppen	happen
hvve	have
hwar	hear
hwat	what
hwld	hold
hwlp	help
hwppen	happen
hwve	have
hxar	hear
hxld	hold
hxlp	help
hxppen	happen
hxve	have
hyar	hear
hyld	hold
hylp	help
hyppen	happen
hyve	have
hzar	hear
hzld	hold
hzlp	help
hzppen	happen
hzve	have
iake	make
ialk	talk
iall	call
iant	want
iappen	happen
iave	have
iay	say
idk	I don't know
iear	hear
ieave	leave
iee	see
ieed	need
ieel	feel
ieem	seem
ieep	keep
iegin	begin
ielieve	believe
iell	tell
ielp	help
ieople	people
iet	let
iff	if
ifnd	find
igve	give
ihat	that
ihe	the
ihey	they
ihing	thing
ihis	this
ihow	show
iill	will
iime	time
iind	find
iit	sit
iith	with
iive	live
ike	like
ilay	play
ill	will
ilve	live
im	him
ime	time
ind	find
inn	in
inow	know
intoo	into
iold	hold
iome	come
iood	good
iook	look
ior	for
iork	work
iot	not
iou	you
iove	move
iring	bring
irite	write
irom	from
irovide	provide
iry	try
ise	use
isk	ask
ist	sit
it	sit
itart	start
ith	with
ither	other
itme	time
its	it's
itt	it
iun	run
iurn	turn
iut	but
ive	I've
iwll	will
iwth	with
jake	make
jalk	talk
jall	call
jant	want
jappen	happen
jave	have
jay	say
jear	year
jeave	leave
jee	see
jeed	need
jeel	feel
jeem	seem
jeep	keep
jegin	begin
jelieve	believe
jell	tell
jelp	help
jeople	people
jet	let
jhat	that
jhe	the
jhey	they
jhing	thing
jhis	this
jhow	show
jill	will
jime	time
jind	find
jit	sit
jith	with
jive	live
jlay	play
jnd	and
jnow	know
jold	hold
jome	come
jood	good
jook	look
jor	for
jork	work
jot	not
jou	you
jove	move
jring	bring
jrite	write
jrom	from
jrovide	provide
jry	try
jse	use
jsk	ask
jtart	start
jther	other
jun	run
jurn	turn
justt	just
jut	put
kaep	keep
kake	make
kalk	talk
kall	call
kant	want
kaow	know
kappen	happen
kave	have
kay	say
kbep	keep
kbow	know
kcep	keep
kcow	know
kdep	keep
kdow	know
keap	keep
kear	hear
keave	leave
kebp	keep
kecp	keep
kedp	keep
kee	keep
keea	keep
keeb	keep
keec	keep
keed	need
keee	keep
keeep	keep
keef	keep
keeg	keep
keeh	keep
keei	keep
keej	keep
keek	keep
keel	keep
keem	keep
keen	keep
keeo	keep
keepp	keep
keeq	keep
keer	keep
kees	keep
keet	keep
keeu	keep
keev	keep
keew	keep
keex	keep
keey	keep
keez	keep
kefp	keep
kegin	begin
kegp	keep
kehp	keep
keip	keep
kejp	keep
kekp	keep
kelieve	believe
kell	tell
kelp	help
kemp	keep
kenp	keep
keop	keep
keople	people
keow	know
kep	keep
kepe	keep
kepp	keep
keqp	keep
kerp	keep
kesp	keep
ket	let
ketp	keep
keup	keep
kevp	keep
kewp	keep
kexp	keep
keyp	keep
kezp	keep
kfep	keep
kfow	know
kgep	keep
kgow	know
khat	that
khe	the
khep	keep
khey	they
khing	thing
khis	this
khow	know
kiep	keep
kill	will
kime	time
kind	find
kiow	know
kit	sit
kith	with
kive	live
kjep	keep
kjow	know
kkeep	keep
kkep	keep
kknow	know
kkow	know
klay	play
klep	keep
klow	know
kmep	keep
kmow	know
knaw	know
knbw	know
kncw	know
knd	and
kndw	know
knep	keep
knew	know
knfw	know
kngw	know
knhw	know
kniw	know
knjw	know
knkw	know
knlw	know
knmw	know
knnow	know
knnw	know
kno	know
knoa	know
knob	know
knoc	know
knod	know
knoe	know
knof	know
knog	know
knoh	know
knoi	know
knoj	know
knok	know
knol	know
knom	know
knon	know
knoo	know
knoow	know
knop	know
knoq	know
knor	know
knos	know
knot	know
knou	know
knov	know
knoww	know
knox	know
knoy	know
knoz	know
knpw	know
knqw	know
knrw	know
knsw	know
kntw	know
knuw	know
knvw	know
knw	know
knwo	know
knww	know
knxw	know
knyw	know
knzw	know
koep	keep
kold	hold
kome	come
konw	know
kood	good
kook	look
koow	know
kor	for
kork	work
kot	not
kou	you
kove	move
kow	know
kpep	keep
kpow	know
kqep	keep
kqow	know
krep	keep
kring	bring
krite	write
krom	from
krovide	provide
krow	know
kry	try
kse	use
ksep	keep
ksk	ask
ksow	know
ktart	start
ktep	keep
kther	other
ktow	know
kuep	keep
kun	run
kuow	know
kurn	turn
kut	put
kvep	keep
kvow	know
kwep	keep
kwow	know
kxep	keep
kxow	know
kyep	keep
kyow	know
kzep	keep
kzow	know
laave	leave
laeve	leave
lake	take
lalk	talk
lall	call
lant	want
laok	look
lappen	happen
lat	let
lave	have
lay	play
lbave	leave
lbok	look
lbt	let
lbve	live
lcave	leave
lcok	look
lct	let
lcve	live
ldave	leave
ldok	look
ldt	let
ldve	live
le	let
lea	let
leaae	leave
leaave	leave
leabe	leave
leace	leave
leade	leave
leae	leave
leaee	leave
leaev	leave
leafe	leave
leage	leave
leahe	leave
leaie	leave
leaje	leave
leake	leave
leale	leave
leame	leave
leane	leave
leaoe	leave
leape	leave
leaqe	leave
lear	year
leare	leave
lease	leave
leate	leave
leaue	leave
leav	leave
leava	leave
leavb	leave
leavc	leave
leavd	leave
leavee	leave
leavf	leave
leavg	leave
leavh	leave
leavi	leave
leavj	leave
leavk	leave
leavl	leave
leavm	leave
leavn	leave
leavo	leave
leavp	leave
leavq	leave
leavr	leave
leavs	leave
leavt	leave
leavu	leave
leavv	leave
leavve	leave
leavw	leave
leavx	leave
leavy	leave
leavz	leave
leawe	leave
leaxe	leave
leaye	leave
leaze	leave
leb	let
lebve	leave
lec	let
lecve	leave
led	let
ledve	leave
lee	let
leeave	leave
leed	need
leel	feel
leem	seem
leep	keep
leet	let
leeve	leave
lef	let
lefve	leave
leg	let
legin	begin
legve	leave
leh	let
lehve	leave
lei	let
leive	leave
lej	let
lejve	leave
lek	let
lekve	leave
lel	let
lelieve	believe
lell	tell
lelp	help
lelve	leave
lem	let
lemve	leave
len	let
lenve	leave
leo	let
leok	look
leople	people
leove	leave
lep	let
lepve	leave
leq	let
leqve	leave
ler	let
lerve	leave
les	let
lesve	leave
lett	let
letve	leave
leu	let
leuve	leave
lev	let
levae	leave
leve	live
levve	leave
lew	let
lewve	leave
lex	let
lexve	leave
ley	let
leyve	leave
lez	let
lezve	leave
lfave	leave
lfok	look
lft	let
lfve	live
lgave	leave
lgok	look
lgt	let
lgve	live
lhat	that
lhave	leave
lhe	the
lhey	they
lhing	thing
lhis	this
lhok	look
lhow	show
lht	let
lhve	live
liae	live
liave	leave
libe	live
lice	live
lide	live
lie	live
liee	live
liev	live
life	live
lige	live
lihe	live
liie	live
liive	live
lije	live
like	live
likee	like
lile	live
lill	will
lime	live
lind	find
line	live
lioe	live
liok	look
lipe	live
liqe	live
lire	live
lise	live
lit	sit
lite	live
lith	with
liue	live
liv	live
liva	live
livb	live
livc	live
livd	live
live	give
livee	live
livf	live
livg	live
livh	live
livi	live
livj	live
livk	live
livl	live
livm	live
livn	live
livo	live
livp	live
livq	live
livr	live
livs	live
livt	live
livu	live
livv	live
livve	live
livw	live
livx	live
livy	live
livz	live
liwe	live
lixe	live
liye	live
lize	live
ljave	leave
ljok	look
ljt	let
ljve	live
lkave	leave
lkok	look
lkt	let
lkve	live
ll	all
llave	leave
llay	play
lleave	leave
llet	let
llive	live
llok	look
llook	look
llt	let
llve	live
lmave	leave
lmok	look
lmt	let
lmve	live
lnave	leave
lnd	and
lnok	look
lnow	know
lnt	let
lnve	live
loak	look
loave	leave
lobk	look
lock	look
lodk	look
loek	look
lofk	look
logk	look
lohk	look
loik	look
lojk	look
lok	look
lokk	look
loko	look
lold	hold
lolk	look
lome	come
lomk	look
lonk	look
loo	look
looa	look
loob	look
looc	look
lood	look
looe	look
loof	look
loog	look
looh	look
looi	look
looj	look
lookk	look
lool	look
loom	look
loon	look
looo	look
loook	look
loop	look
looq	look
loor	look
loos	look
loot	look
loou	look
loov	look
loow	look
loox	look
looy	look
looz	look
lopk	look
loqk	look
lor	for
lork	look
losk	look
lot	let
lotk	look
lou	you
louk	look
love	live
lovk	look
lowk	look
loxk	look
loyk	look
lozk	look
lpave	leave
lpay	play
lpok	look
lpt	let
lpve	live
lqave	leave
lqok	look
lqt	let
lqve	live
lrave	leave
lring	bring
lrite	write
lrok	look
lrom	from
lrovide	provide
lrt	let
lrve	live
lry	try
lsave	leave
lse	use
lsk	ask
lsok	look
lst	let
lsve	live
lt	let
ltart	start
ltave	leave
lte	let
lther	other
ltok	look
ltt	let
ltve	live
luave	leave
lun	run
luok	look
lurn	turn
lut	put
luve	live
lvave	leave
lve	live
lvie	live
lvok	look
lvt	let
lvve	live
lwave	leave
lwok	look
lwt	let
lwve	live
lxave	leave
lxok	look
lxt	let
lxve	live
lyave	leave
lyok	look
lyt	let
lyve	live
lzave	leave
lzok	look
lzt	let
lzve	live
maae	make
maake	make
mabe	make
mace	make
made	make
mae	make
maee	make
maek	make
mafe	make
mage	make
mahe	make
maie	make
maje	make
mak	make
maka	make
makb	make
makc	make
makd	make
make	take
makee	make
makf	make
makg	make
makh	make
maki	make
makj	make
makk	make
makke	make
makl	make
makm	make
makn	make
mako	make
makp	make
makq	make
makr	make
maks	make
makt	make
maku	make
makv	make
makw	make
makx	make
maky	make
makz	make
male	make
malk	talk
mall	call
mame	make
mane	make
mant	want
maoe	make
mape	make
mappen	happen
maqe	make
mare	make
mase	make
mate	make
maue	make
mave	make
mawe	make
maxe	make
may	say
maye	make
maze	make
mbke	make
mbve	move
mcke	make
mcve	move
mdke	make
mdve	move
mear	hear
meave	leave
mee	me
meed	need
meel	feel
meem	seem
meep	keep
megin	begin
meke	make
melieve	believe
mell	tell
melp	help
meople	people
met	let
meve	move
mfke	make
mfve	move
mgke	make
mgve	move
mhat	that
mhe	the
mhey	they
mhing	thing
mhis	this
mhke	make
mhow	show
mhve	move
mike	make
mill	will
mime	time
mind	find
mit	sit
mith	with
mive	live
mjke	make
mjve	move
mkae	make
mke	make
mkke	make
mkve	move
mlay	play
mlke	make
mlve	move
mmake	make
mmke	make
mmove	move
mmve	move
mnd	and
mnke	make
mnow	know
mnve	move
mo	from
moae	move
mobe	move
moce	move
mode	move
moe	move
moee	move
moev	move
mofe	move
moge	move
mohe	move
moie	move
moje	move
moke	make
mold	hold
mole	move
mome	move
mone	move
mood	good
mooe	move
mook	look
moove	move
mope	move
moqe	move
mor	for
more	move
mork	work
mose	move
mot	not
mote	move
mou	you
moue	move
mov	move
mova	move
movb	move
movc	move
movd	move
movee	move
movf	move
movg	move
movh	move
movi	move
movj	move
movk	move
movl	move
movm	move
movn	move
movo	move
movp	move
movq	move
movr	move
movs	move
movt	move
movu	move
movv	move
movve	move
movw	move
movx	move
movy	move
movz	move
mowe	move
moxe	move
moye	move
moze	move
mpke	make
mpve	move
mqke	make
mqve	move
mring	bring
mrite	write
mrke	make
mrom	from
mrovide	provide
mrve	move
mry	try
mse	use
msk	ask
mske	make
msve	move
mtart	start
mther	other
mtke	make
mtve	move
muke	make
mun	run
murn	turn
mut	but
muve	move
mve	move
mvke	make
mvoe	move
mvve	move
mwke	make
mwve	move
mxke	make
mxve	move
myke	make
myve	move
myy	my
mzke	make
mzve	move
nad	and
naed	need
nake	take
nalk	talk
nall	call
nant	want
nappen	happen
nat	not
nave	have
nay	say
nbed	need
nbt	not
nced	need
nct	not
nd	and
nded	need
ndt	not
ne	when
nead	need
near	hear
neave	leave
nebd	need
neccessary	necessary
necd	need
ned	need
nedd	need
nede	need
nee	see
neea	need
neeb	need
neec	need
needd	need
neee	need
neeed	need
neef	need
neeg	need
neeh	need
neei	need
neej	need
neek	need
neel	feel
neem	seem
neen	need
neeo	need
neep	keep
neeq	need
neer	need
nees	need
neet	need
neeu	need
neev	need
neew	need
neex	need
neey	need
neez	need
nefd	need
negd	need
negin	begin
nehd	need
neid	need
nejd	need
nekd	need
neld	need
nelieve	believe
nell	tell
nelp	help
nemd	need
nend	need
neod	need
neople	people
nepd	need
neqd	need
nerd	need
nesd	need
net	not
netd	need
neud	need
nevd	need
newd	need
nexd	need
neyd	need
nezd	need
nfed	need
nft	not
nged	need
ngt	not
nhat	that
nhe	the
nhed	need
nhey	they
nhing	thing
nhis	this
nhow	show
nht	not
nied	need
nill	will
nime	time
nind	find
nit	not
nith	with
nive	give
njed	need
njt	not
nked	need
nkow	know
nkt	not
nlay	play
nled	need
nlt	not
nmed	need
nmt	not
nnd	and
nned	need
nneed	need
nnot	not
nnow	know
nnt	not
no	not
noa	not
nob	not
noc	not
nod	not
noe	not
noed	need
nof	not
nog	not
noh	not
noi	not
noj	not
nok	not
nol	not
nold	hold
nom	not
nome	come
non	not
noo	no
nood	good
nook	look
noot	not
nop	not
noq	not
nor	not
nork	work
nos	not
nott	not
nou	you
nov	not
nove	move
now	know
nox	not
noy	not
noz	not
nped	need
npt	not
nqed	need
nqt	not
nred	need
nring	bring
nrite	write
nrom	from
nrovide	provide
nrt	not
nry	try
nse	use
nsed	need
nsk	ask
nst	not
nt	not
ntart	start
nted	need
nther	other
nto	into
ntt	not
nued	need
nun	run
nurn	turn
nut	not
nved	need
nvt	not
nwed	need
nwt	not
nxed	need
nxt	not
nyed	need
nyt	not
nzed	need
nzt	not
oaher	other
oake	take
oalk	talk
oall	call
oant	want
oappen	happen
oave	have
oay	say
obher	other
occassion	occasion
occured	occurred
ocher	other
ocme	come
odher	other
oear	year
oeave	leave
oee	see
oeed	need
oeel	feel
oeem	seem
oeep	keep
oegin	begin
oeher	other
oelieve	believe
oell	tell
oelp	help
oeople	people
oet	let
off	of
ofher	other
ofr	for
ogher	other
ogod	good
ohat	that
ohe	the
oher	other
ohey	they
ohher	other
ohing	thing
ohis	this
ohld	hold
ohow	show
ohter	other
oiher	other
oill	will
oime	time
oind	find
oit	sit
oith	with
oive	live
ojher	other
okher	other
olay	play
old	hold
olher	other
olok	look
ome	some
omg	oh my god
omher	other
omve	move
ond	and
onee	one
onher	other
onn	on
onow	know
ont	not
ood	good
ooher	other
ook	look
oold	hold
oome	come
oood	good
oook	look
oor	for
oork	work
oot	not
oother	other
oou	you
oove	move
opher	other
oqher	other
orher	other
oring	bring
orite	write
ork	work
orom	from
orovide	provide
orr	or
ory	try
ose	use
osher	other
osk	ask
ot	not
otaer	other
otart	start
otber	other
otcer	other
otder	other
oteer	other
otehr	other
oter	other
otfer	other
otger	other
othar	other
othbr	other
othcr	other
othdr	other
othe	other
othea	other
otheb	other
othec	other
othed	other
othee	other
otheer	other
othef	other
otheg	other
otheh	other
othei	other
othej	other
othek	other
othel	other
othem	other
othen	other
otheo	other
othep	other
otheq	other
otherr	other
othes	other
othet	other
otheu	other
othev	other
othew	other
othex	other
othey	other
othez	other
othfr	other
othgr	other
othher	other
othhr	other
othir	other
othjr	other
othkr	other
othlr	other
othmr	other
othnr	other
othor	other
othpr	other
othqr	other
othr	other
othre	other
othrr	other
othsr	other
othtr	other
othur	other
othvr	other
othwr	other
othxr	other
othyr	other
othzr	other
otier	other
otjer	other
otker	other
otler	other
otmer	other
otner	other
otoer	other
otper	other
otqer	other
otrer	other
otser	other
otter	other
otther	other
otuer	other
otver	other
otwer	other
otxer	other
otyer	other
otzer	other
ou	you
ouher	other
ould	could
oun	run
our	your
ourn	turn
out	but
outt	out
ove	move
ovher	other
owher	other
owrk	work
oxher	other
oyher	other
oyu	you
ozher	other
paay	play
pake	make
palk	talk
pall	call
paly	play
pant	want
paople	people
paovide	provide
pappen	happen
pat	put
pave	have
pay	play
pbay	play
pbople	people
pbovide	provide
pbt	put
pcay	play
pcople	people
pcovide	provide
pct	put
pday	play
pdople	people
pdovide	provide
pdt	put
peaple	people
pear	year
peave	leave
peay	play
pebple	people
pecple	people
pedple	people
pee	see
peed	need
peel	feel
peem	seem
peeople	people
peep	keep
peeple	people
pefple	people
pegin	begin
pegple	people
pehple	people
peiple	people
pejple	people
pekple	people
pelieve	believe
pell	tell
pelp	help
pelple	people
pemple	people
penple	people
peoale	people
peoble	people
peocle	people
peodle	people
peoele	people
peofle	people
peogle	people
peohle	people
peoile	people
peojle	people
peokle	people
peole	people
peolle	people
peolpe	people
peomle	people
peonle	people
peoole	people
peoople	people
peopae	people
peopbe	people
peopce	people
peopde	people
peope	people
peopee	people
peopel	people
peopfe	people
peopge	people
peophe	people
peopie	people
peopje	people
peopke	people
peopl	people
peopla	people
peoplb	people
peoplc	people
peopld	people
peoplee	people
peoplf	people
peoplg	people
peoplh	people
peopli	people
peoplj	people
peoplk	people
peopll	people
peoplle	people
peoplm	people
peopln	people
peoplo	people
peoplp	people
peoplq	people
peoplr	people
peopls	people
peoplt	people
peoplu	people
peoplv	people
peoplw	people
peoplx	people
peoply	people
peoplz	people
peopme	people
peopne	people
peopoe	people
peoppe	people
peopple	people
peopqe	people
peopre	people
peopse	people
peopte	people
peopue	people
peopve	people
peopwe	people
peopxe	people
peopye	people
peopze	people
peoqle	people
peorle	people
peosle	people
peotle	people
peoule	people
peovide	provide
peovle	people
peowle	people
peoxle	people
peoyle	people
peozle	people
peple	people
pepole	people
pepple	people
peqple	people
perple	people
persue	pursue
pesple	people
pet	put
petple	people
peuple	people
pevple	people
pewple	people
pexple	people
peyple	people
pezple	people
pfay	play
pfople	people
pfovide	provide
pft	put
pgay	play
pgople	people
pgovide	provide
pgt	put
phat	that
phay	play
phe	the
phey	they
phing	thing
phis	this
phople	people
phovide	provide
phow	show
pht	put
piay	play
pill	will
pime	time
pind	find
piople	people
piovide	provide
pit	sit
pith	with
pive	live
pjay	play
pjople	people
pjovide	provide
pjt	put
pkay	play
pkople	people
pkovide	provide
pkt	put
pla	play
plaa	play
plaay	play
plab	play
plac	play
plad	play
plae	play
plaf	play
plag	play
plah	play
plai	play
plaj	play
plak	play
plal	play
plam	play
plan	play
plao	play
plap	play
plaq	play
plar	play
plas	play
plat	play
plau	play
plav	play
plaw	play
plax	play
playy	play
plaz	play
plby	play
plcy	play
pldy	play
pley	play
plfy	play
plgy	play
plhy	play
pliy	play
pljy	play
plky	play
pllay	play
plly	play
plmy	play
plny	play
plople	people
plovide	provide
ploy	play
plpy	play
plqy	play
plry	play
pls	please
plsy	play
plt	put
plty	play
pluy	play
plvy	play
plwy	play
plxy	play
ply	play
plya	play
plyy	play
plz	please
plzy	play
pmay	play
pmople	people
pmovide	provide
pmt	put
pnay	play
pnd	and
pnople	people
pnovide	provide
pnow	know
pnt	put
poay	play
poeple	people
pold	hold
pome	come
pood	good
pook	look
poople	people
poovide	provide
pople	people
por	for
pork	work
porvide	provide
pot	put
pou	you
pove	move
povide	provide
ppay	play
ppeople	people
pplay	play
ppople	people
ppovide	provide
pprovide	provide
ppt	put
pput	put
pqay	play
pqople	people
pqovide	provide
pqt	put
pravide	provide
pray	play
prbvide	provide
prcvide	provide
prdvide	provide
previde	provide
prfvide	provide
prgvide	provide
pring	bring
prite	write
privide	provide
prjvide	provide
prkvide	provide
prlvide	provide
prmvide	provide
prnvide	provide
proaide	provide
probide	provide
procide	provide
prodide	provide
proeide	provide
profide	provide
progide	provide
prohide	provide
proide	provide
proiide	provide
proivde	provide
projide	provide
prokide	provide
prolide	provide
prom	from
promide	provide
pronide	provide
prooide	provide
proovide	provide
propide	provide
prople	people
proqide	provide
proride	provide
proside	provide
protide	provide
prouide	provide
provade	provide
provbde	provide
provcde	provide
provdde	provide
provde	provide
provdie	provide
provede	provide
provfde	provide
provgde	provide
provhde	provide
proviae	provide
provibe	provide
provice	provide
provid	provide
provida	provide
providb	provide
providc	provide
providd	provide
providde	provide
providee	provide
providf	provide
providg	provide
providh	provide
providi	provide
providj	provide
providk	provide
providl	provide
providm	provide
providn	provide
provido	provide
providp	provide
providq	provide
provids	provide
providt	provide
providu	provide
providv	provide
providw	provide
providx	provide
providy	provide
providz	provide
provie	provide
provied	provide
proviee	provide
provife	provide
provige	provide
provihe	provide
proviide	provide
proviie	provide
provije	provide
provike	provide
provile	provide
provime	provide
provine	provide
provioe	provide
provipe	provide
proviqe	provide
provire	provide
provise	provide
provite	provide
proviue	provide
provive	provide
proviwe	provide
provixe	provide
proviye	provide
provize	provide
provjde	provide
provkde	provide
provlde	provide
provmde	provide
provnde	provide
provode	provide
provpde	provide
provqde	provide
provrde	provide
provsde	provide
provtde	provide
provude	provide
provvde	provide
provvide	provide
provwde	provide
provxde	provide
provyde	provide
provzde	provide
prowide	provide
proxide	provide
proyide	provide
prozide	provide
prpvide	provide
prqvide	provide
prrovide	provide
prrvide	provide
prsvide	provide
prt	put
prtvide	provide
pruvide	provide
prvide	provide
prvoide	provide
prvvide	provide
prwvide	provide
prxvide	provide
pry	try
pryvide	provide
przvide	provide
psay	play
pse	use
psk	ask
psople	people
psovide	provide
pst	put
pt	put
ptart	start
ptay	play
pther	other
ptople	people
ptovide	provide
ptt	put
ptu	put
pu	put
pua	put
puay	play
pub	put
puc	put
pud	put
pue	put
puf	put
pug	put
puh	put
pui	put
puj	put
puk	put
pul	put
pum	put
pun	run
puo	put
puople	people
puovide	provide
pup	put
puq	put
pur	put
purn	turn
pus	put
put	but
putt	put
puu	put
puut	put
puv	put
puw	put
pux	put
puy	put
puz	put
pvay	play
pvople	people
pvovide	provide
pvt	put
pway	play
pwople	people
pwovide	provide
pwt	put
pxay	play
pxovide	provide
pxt	put
pyay	play
pyople	people
pyovide	provide
pyt	put
pzay	play
pzople	people
pzovide	provide
pzt	put
qake	make
qalk	talk
qall	call
qant	want
qappen	happen
qave	have
qay	say
qear	year
qeave	leave
qee	see
qeed	need
qeel	feel
qeem	seem
qeep	keep
qegin	begin
qelieve	believe
qell	tell
qelp	help
qeople	people
qet	let
qhat	that
qhe	the
qhey	they
qhing	thing
qhis	this
qhow	show
qill	will
qime	time
qind	find
qit	sit
qith	with
qive	give
qlay	play
qnd	and
qnow	know
qold	hold
qome	come
qood	good
qook	look
qor	for
qork	work
qot	not
qou	you
qove	move
qring	bring
qrite	write
qrom	from
qrovide	provide
qry	try
qse	use
qsk	ask
qtart	start
qther	other
qun	run
qurn	turn
qut	put
ra	year
rake	make
ralk	talk
rall	call
ran	run
rant	want
rappen	happen
rave	have
ray	say
rbing	bring
rbn	run
rcn	run
rdn	run
re	other
rear	year
reave	leave
reccomend	recommend
recieve	receive
ree	see
reed	need
reel	feel
reem	seem
reep	keep
refered	referred
regin	begin
relieve	believe
rell	tell
relp	help
ren	run
reople	people
ret	let
rfn	run
rfom	from
rgn	run
rhat	that
rhe	the
rhey	they
rhing	thing
rhis	this
rhn	run
rhow	show
ri	their
rill	will
rime	time
rin	run
rind	find
ring	bring
rit	sit
rite	write
rith	with
rive	give
rjn	run
rkn	run
rlay	play
rln	run
rmn	run
rn	run
rnd	and
rnn	run
rnow	know
rnu	run
rold	hold
rom	from
rome	come
ron	run
rood	good
rook	look
ror	for
rork	work
rot	not
rou	you
rove	move
rovide	provide
rpn	run
rpovide	provide
rqn	run
rring	bring
rrite	write
rrn	run
rrom	from
rrovide	provide
rrun	run
rry	try
rse	use
rsk	ask
rsn	run
rtart	start
rther	other
rtn	run
rty	try
ru	your
rua	run
rub	run
ruc	run
rud	run
rue	run
ruf	run
rug	run
ruh	run
rui	run
ruj	run
ruk	run
rul	run
rum	run
runn	run
ruo	run
rup	run
ruq	run
rur	run
rurn	turn
rus	run
rut	put
ruu	run
ruun	run
ruv	run
ruw	run
rux	run
ruy	run
ruz	run
rvn	run
rwite	write
rwn	run
rxn	run
ry	try
ryn	run
rzn	run
sa	say
saa	say
saart	start
saay	say
sab	say
sac	say
sad	say
sae	say
saem	seem
saf	say
sag	say
sah	say
sai	say
saj	say
sak	ask
sake	take
sal	say
salk	talk
sall	call
sam	say
san	say
sant	want
sao	say
saow	show
sap	say
sappen	happen
saq	say
sar	say
sart	start
sas	say
sat	say
satrt	start
sau	say
sav	say
save	have
saw	say
sax	say
sayy	say
saz	say
sbart	start
sbe	see
sbem	seem
sbow	show
sbt	sit
sby	say
scart	start
sce	see
scem	seem
scow	show
sct	sit
scy	say
sdart	start
sde	see
sdem	seem
sdow	show
sdt	sit
sdy	say
se	use
sea	see
seam	seem
sear	hear
seart	start
seave	leave
seb	see
sebm	seem
sec	see
secm	seem
sed	see
sedm	seem
see	seem
seea	seem
seeb	seem
seec	seem
seed	seem
seee	see
seeem	seem
seef	seem
seeg	seem
seeh	seem
seei	seem
seej	seem
seek	seem
seel	seem
seemm	seem
seen	seem
seeo	seem
seep	keep
seeq	seem
seer	seem
sees	seem
seet	seem
seeu	seem
seev	seem
seew	seem
seex	seem
seey	seem
seez	seem
sef	see
sefm	seem
seg	see
segin	begin
segm	seem
seh	see
sehm	seem
sei	see
seim	seem
sej	see
sejm	seem
sek	see
sekm	seem
sel	see
selieve	believe
sell	tell
selm	seem
selp	help
sem	seem
seme	seem
semm	seem
sen	see
senm	seem
seo	see
seom	seem
seople	people
seow	show
sep	see
seperate	separate
sepm	seem
seq	see
seqm	seem
ser	see
serm	seem
ses	see
sesm	seem
set	let
setm	seem
seu	see
seum	seem
sev	see
sevm	seem
sew	see
sewm	seem
sex	see
sexm	seem
sey	say
seym	seem
sez	see
sezm	seem
sfart	start
sfe	see
sfem	seem
sfow	show
sft	sit
sfy	say
sgart	start
sge	see
sgem	seem
sgow	show
sgt	sit
sgy	say
shart	start
shat	that
shaw	show
shbw	show
shcw	show
shdw	show
she	see
shee	she
shem	seem
shes	she's
shew	show
shey	they
shfw	show
shgw	show
shhow	show
shhw	show
shing	thing
shis	this
shiw	show
shjw	show
shkw	show
shlw	show
shmw	show
shnw	show
sho	show
shoa	show
shob	show
shoc	show
shod	show
shoe	show
shof	show
shog	show
shoh	show
shoi	show
shoj	show
shok	show
shol	show
shom	show
shon	show
shoo	show
shoow	show
shop	show
shoq	show
shor	show
shos	show
shot	show
shou	show
shoulda	should have
shouldnt	shouldn't
shov	show
showw	show
shox	show
shoy	show
shoz	show
shpw	show
shqw	show
shrw	show
shsw	show
sht	sit
shtw	show
shuw	show
shvw	show
shw	show
shwo	show
shww	show
shxw	show
shy	say
shyw	show
shzw	show
si	this
sia	sit
siart	start
sib	sit
sic	sit
sid	sit
sie	see
siem	seem
sif	sit
sig	sit
sih	sit
sii	sit
siit	sit
sij	sit
sik	sit
sil	sit
sill	will
sim	sit
sime	time
sin	sit
sind	find
sio	sit
siow	show
sip	sit
siq	sit
sir	sit
sis	sit
sith	with
sitt	sit
siu	sit
siv	sit
sive	live
siw	sit
six	sit
siy	say
siz	sit
sjart	start
sje	see
sjem	seem
sjow	show
sjt	sit
sjy	say
sk	ask
skart	start
ske	see
skem	seem
skow	show
skt	sit
sky	say
slart	start
slay	play
sle	see
slem	seem
slow	show
slt	sit
sly	say
smart	start
sme	see
smem	seem
smow	show
smt	sit
smy	say
snart	start
snd	and
sne	see
snem	seem
snow	know
snt	sit
sny	say
soart	start
soe	see
soem	seem
sohw	show
sold	hold
some	come
somee	some
soo	so
sood	good
sook	look
soow	show
sor	for
sork	work
sot	sit
sou	you
sove	move
sow	show
soy	say
spart	start
spe	see
spem	seem
spow	show
spt	sit
spy	say
sqart	start
sqe	see
sqem	seem
sqow	show
sqt	sit
sqy	say
srart	start
sre	see
srem	seem
sring	bring
srite	write
srom	from
srovide	provide
srow	show
srt	sit
sry	say
ssart	start
ssay	say
sse	see
ssee	see
sseem	seem
ssem	seem
sshow	show
ssit	sit
ssk	ask
ssow	show
sst	sit
sstart	start
ssy	say
st	sit
staart	start
staat	start
stabt	start
stact	start
stadt	start
staet	start
staft	start
stagt	start
staht	start
stait	start
stajt	start
stakt	start
stalt	start
stamt	start
stant	start
staot	start
stapt	start
staqt	start
star	start
stara	start
starb	start
starc	start
stard	start
stare	start
starf	start
starg	start
starh	start
stari	start
starj	start
stark	start
starl	start
starm	start
starn	start
staro	start
starp	start
starq	start
starr	start
starrt	start
stars	start
startt	start
staru	start
starv	start
starw	start
starx	start
stary	start
starz	start
stast	start
stat	start
statr	start
statt	start
staut	start
stavt	start
stawt	start
staxt	start
stayt	start
stazt	start
stbrt	start
stcrt	start
stdrt	start
ste	see
stem	seem
stert	start
stfrt	start
stgrt	start
sther	other
sthrt	start
sti	sit
stirt	start
stjrt	start
stkrt	start
stlrt	start
stmrt	start
stnrt	start
stort	start
stow	show
stprt	start
stqrt	start
strat	start
strrt	start
strt	start
stsrt	start
stt	sit
sttart	start
sttrt	start
sturt	start
stvrt	start
stwrt	start
stxrt	start
sty	say
styrt	start
stzrt	start
suart	start
succeded	succeeded
sue	use
suem	seem
sun	run
suow	show
surn	turn
sut	but
suy	say
svart	start
sve	see
svem	seem
svow	show
svt	sit
svy	say
swart	start
swe	see
swem	seem
swow	show
swt	sit
swy	say
sxart	start
sxe	see
sxem	seem
sxow	show
sxt	sit
sxy	say
sy	say
sya	say
syart	start
sye	see
syem	seem
syow	show
syt	sit
syy	say
szart	start
sze	see
szem	seem
szow	show
szt	sit
szy	say
ta	what
taae	take
taak	talk
taake	take
taalk	talk
taat	that
tabe	take
tabk	talk
tace	take
tack	talk
tade	take
tadk	talk
tae	take
taee	take
taek	take
taey	they
tafe	take
tafk	talk
tage	take
tagk	talk
tahe	take
tahk	talk
taht	that
taie	take
taik	talk
taing	thing
tais	this
taje	take
tajk	talk
tak	take
taka	take
takb	take
takc	take
takd	take
take	make
takee	take
takf	take
takg	take
takh	take
taki	take
takj	take
takk	talk
takke	take
takl	talk
takm	take
takn	take
tako	take
takp	take
takq	take
takr	take
taks	take
takt	take
taku	take
takv	take
takw	take
takx	take
taky	take
takz	take
tal	talk
tala	talk
talb	talk
talc	talk
tald	talk
tale	take
talf	talk
talg	talk
talh	talk
tali	talk
talj	talk
talkk	talk
tall	talk
tallk	talk
talm	talk
taln	talk
talo	talk
talp	talk
talq	talk
talr	talk
tals	talk
talt	talk
talu	talk
talv	talk
talw	talk
talx	talk
taly	talk
talz	talk
tame	take
tamk	talk
tane	take
tank	talk
tant	want
taoe	take
taok	talk
tape	take
tapk	talk
tappen	happen
taqe	take
taqk	talk
tare	take
tark	talk
tarn	turn
tart	start
tase	take
task	talk
tat	that
tate	take
tatk	talk
taue	take
tauk	talk
tave	have
tavk	talk
tawe	take
tawk	talk
taxe	take
taxk	talk
tay	try
taye	take
tayk	talk
taze	take
tazk	talk
tbat	that
tbe	the
tbey	they
tbh	to be honest
tbing	thing
tbis	this
tbke	take
tblk	talk
tbll	tell
tbme	time
tbrn	turn
tby	try
tcat	that
tce	the
tcey	they
tcing	thing
tcis	this
tcke	take
tclk	talk
tcll	tell
tcme	time
tcrn	turn
tcy	try
tdat	that
tde	the
tdey	they
tding	thing
tdis	this
tdke	take
tdlk	talk
tdll	tell
tdme	time
tdrn	turn
tdy	try
te	the
teal	tell
tear	year
teat	that
teave	leave
tebl	tell
tecl	tell
tedl	tell
tee	the
teed	need
teel	tell
teell	tell
teem	seem
teep	keep
teey	they
tefl	tell
tegin	begin
tegl	tell
teh	the
tehl	tell
tehy	they
teil	tell
teing	thing
teis	this
tejl	tell
teke	take
tekl	tell
tel	tell
tela	tell
telb	tell
telc	tell
teld	tell
tele	tell
telf	tell
telg	tell
telh	tell
teli	tell
telieve	believe
telj	tell
telk	talk
telll	tell
telm	tell
teln	tell
telo	tell
telp	tell
telq	tell
telr	tell
tels	tell
telt	tell
telu	tell
telv	tell
telw	tell
telx	tell
tely	tell
telz	tell
teme	time
teml	tell
tenl	tell
teol	tell
teople	people
tepl	tell
teql	tell
terl	tell
tern	turn
tesl	tell
tet	let
tetl	tell
teul	tell
tevl	tell
tewl	tell
texl	tell
tey	they
teyl	tell
tezl	tell
tfat	that
tfe	the
tfey	they
tfing	thing
tfis	this
tfke	take
tflk	talk
tfll	tell
tfme	time
tfrn	turn
tfy	try
tgat	that
tge	the
tgey	they
tging	thing
tgis	this
tgke	take
tglk	talk
tgll	tell
tgme	time
tgrn	turn
tgy	try
th	the
tha	that
thaa	that
thaat	that
thab	that
thac	that
thad	that
thae	that
thaf	that
thag	that
thah	that
thai	that
thaj	that
thak	that
thal	that
tham	that
than	that
thang	thing
thao	that
thap	that
thaq	that
thar	that
thas	this
thatt	that
thau	that
thav	that
thaw	that
thax	that
thay	they
thaz	that
thb	the
thbng	thing
thbs	this
thbt	that
thby	they
thc	the
thcng	thing
thcs	this
thct	that
thcy	they
thd	the
thdng	thing
thds	this
thdt	that
thdy	they
the	they
thea	they
theb	they
thec	they
thed	they
thee	the
theey	they
thef	they
theg	they
theh	they
thei	they
theirr	their
thej	they
thek	they
thel	they
them	they
themm	them
then	they
theng	thing
theo	they
thep	they
theq	they
ther	other
theree	there
thes	this
thet	they
theu	they
thev	they
thew	they
thex	they
theyre	they're
theyy	they
thez	they
thf	the
thfng	thing
thfs	this
thft	that
thfy	they
thg	the
thgng	thing
thgs	this
thgt	that
thgy	they
thh	the
thhat	that
thhe	the
thhey	they
thhing	thing
thhis	this
thhng	thing
thhs	this
thht	that
thhy	they
thi	this
thia	this
thiag	thing
thib	this
thibg	thing
thic	this
thicg	thing
thid	this
thidg	thing
thie	this
thieg	thing
thier	their
thif	this
thifg	thing
thig	thing
thigg	thing
thign	thing
thih	this
thihg	thing
thii	this
thiig	thing
thiing	thing
thiis	this
thij	this
thijg	thing
thik	this
thikg	thing
thil	this
thilg	thing
thim	this
thimg	thing
thin	thing
thina	thing
thinb	thing
thinc	thing
thind	thing
thine	thing
thinf	thing
thingg	thing
thinh	thing
thini	thing
thinj	thing
think	thing
thinl	thing
thinm	thing
thinn	thing
thinng	thing
thino	thing
thinp	thing
thinq	thing
thinr	thing
thins	thing
thint	thing
thinu	thing
thinv	thing
thinw	thing
thinx	thing
thiny	thing
thinz	thing
thio	this
thiog	thing
thip	this
thipg	thing
thiq	this
thiqg	thing
thir	this
thirg	thing
thisg	thing
thiss	this
thit	that
thitg	thing
thiu	this
thiug	thing
thiv	this
thivg	thing
thiw	this
thiwg	thing
thix	this
thixg	thing
thiy	this
thiyg	thing
thiz	this
thizg	thing
thj	the
thjng	thing
thjs	this
thjt	that
thjy	they
thk	the
thke	take
thkng	thing
thks	this
thkt	that
thky	they
thl	the
thlk	talk
thll	tell
thlng	thing
thls	this
thlt	that
thly	they
thm	the
thme	time
thmng	thing
thms	this
thmt	that
thmy	they
thn	the
thne	then
thng	thing
thnig	thing
thnng	thing
thns	this
thnt	that
thny	they
tho	the
thong	thing
thos	this
thot	that
thow	show
thoy	they
thp	the
thpng	thing
thps	this
thpt	that
thpy	they
thq	the
thqng	thing
thqs	this
thqt	that
thqy	they
thr	the
thrn	turn
thrng	thing
thrs	this
thrt	that
thry	they
ths	the
thsi	this
thsng	thing
thss	this
thst	that
thsy	they
tht	that
thta	that
thtng	thing
thts	this
thtt	that
thty	they
thu	the
thung	thing
thus	this
thut	that
thuy	they
thv	the
thvng	thing
thvs	this
thvt	that
thvy	they
thw	the
thwng	thing
thws	this
thwt	that
thwy	they
thx	thanks
thxng	thing
thxs	this
thxt	that
thxy	they
thy	they
thye	they
thyng	thing
thys	this
thyt	that
thyy	they
thz	the
thzng	thing
thzs	this
thzt	that
thzy	they
tiae	time
tiat	that
tibe	time
tice	time
tide	time
tie	time
tiee	time
tiem	time
tiey	they
tife	time
tige	time
tihe	time
tihng	thing
tihs	this
tiie	time
tiime	time
tiing	thing
tiis	this
tije	time
tike	time
tile	time
tilk	talk
till	tell
tim	time
tima	time
timb	time
timc	time
timd	time
timee	time
timf	time
timg	time
timh	time
timi	time
timj	time
timk	time
timl	time
timm	time
timme	time
timn	time
timo	time
timp	time
timq	time
timr	time
tims	time
timt	time
timu	time
timv	time
timw	time
timx	time
timy	time
timz	time
tind	find
tine	time
ting	thing
tioe	time
tipe	time
tiqe	time
tire	time
tirn	turn
tis	this
tise	time
tit	sit
tite	time
tith	with
tiue	time
tive	time
tiwe	time
tixe	time
tiy	try
tiye	time
tize	time
tjat	that
tje	the
tjey	they
tjing	thing
tjis	this
tjke	take
tjlk	talk
tjll	tell
tjme	time
tjrn	turn
tjy	try
tkae	take
tkat	that
tke	take
tkey	they
tking	thing
tkis	this
tkke	take
tklk	talk
tkll	tell
tkme	time
tkrn	turn
tky	try
tlak	talk
tlat	that
tlay	play
tle	the
tlel	tell
tley	they
tling	thing
tlis	this
tlk	talk
tlke	take
tll	tell
tllk	talk
tlll	tell
tlme	time
tlrn	turn
tly	try
tmat	that
tme	time
tmey	they
tmie	time
tming	thing
tmis	this
tmke	take
tmlk	talk
tmll	tell
tmme	time
tmrn	turn
tmy	try
tnat	that
tnd	and
tne	the
tney	they
tning	thing
tnis	this
tnke	take
tnlk	talk
tnll	tell
tnme	time
tnow	know
tnrn	turn
tny	try
toat	that
toe	the
toey	they
toher	other
toing	thing
tois	this
toke	take
told	hold
tolk	talk
toll	tell
tome	time
too	to
tood	good
took	look
tor	for
tork	work
torn	turn
tot	not
tou	you
tove	move
toy	try
tpat	that
tpe	the
tpey	they
tping	thing
tpis	this
tpke	take
tplk	talk
tpll	tell
tpme	time
tprn	turn
tpy	try
tqat	that
tqe	the
tqey	they
tqing	thing
tqis	this
tqke	take
tqlk	talk
tqll	tell
tqme	time
tqrn	turn
tqy	try
tr	try
tra	try
trat	that
trb	try
trc	try
trd	try
tre	try
trey	they
trf	try
trg	try
trh	try
tri	try
tring	bring
tris	this
trite	write
trj	try
trk	try
trke	take
trl	try
trlk	talk
trll	tell
trm	try
trme	time
trn	turn
tro	try
trom	from
trovide	provide
trp	try
trq	try
trr	try
trrn	turn
trry	try
trs	try
trt	try
tru	try
trun	turn
trv	try
trw	try
trx	try
tryy	try
trz	try
ts	just
tsart	start
tsat	that
tse	the
tsey	they
tsing	thing
tsis	this
tsk	ask
tske	take
tslk	talk
tsll	tell
tsme	time
tsrn	turn
tsy	try
ttake	take
ttalk	talk
ttart	start
ttat	that
tte	the
ttell	tell
ttey	they
tthat	that
tthe	the
tther	other
tthey	they
tthing	thing
tthis	this
ttime	time
tting	thing
ttis	this
ttke	take
ttlk	talk
ttll	tell
ttme	time
ttrn	turn
ttry	try
tturn	turn
tty	try
tu	about
tuan	turn
tuat	that
tubn	turn
tucn	turn
tudn	turn
tue	the
tuen	turn
tuey	they
tufn	turn
tugn	turn
tuhn	turn
tuin	turn
tuing	thing
tuis	this
tujn	turn
tuke	take
tukn	turn
tulk	talk
tull	tell
tuln	turn
tume	time
tumn	turn
tun	turn
tunn	turn
tunr	turn
tuon	turn
tupn	turn
tuqn	turn
tur	turn
tura	turn
turb	turn
turc	turn
turd	turn
ture	turn
turf	turn
turg	turn
turh	turn
turi	turn
turj	turn
turk	turn
turl	turn
turm	turn
turnn	turn
turo	turn
turp	turn
turq	turn
turr	turn
turrn	turn
turs	turn
turt	turn
turu	turn
turv	turn
turw	turn
turx	turn
tury	turn
turz	turn
tusn	turn
tut	but
tutn	turn
tuun	turn
tuurn	turn
tuvn	turn
tuwn	turn
tuxn	turn
tuy	try
tuyn	turn
tuzn	turn
tvat	that
tve	the
tvey	they
tving	thing
tvis	this
tvke	take
tvlk	talk
tvll	tell
tvme	time
tvrn	turn
tvy	try
twat	that
twe	the
twey	they
twing	thing
twis	this
twke	take
twlk	talk
twll	tell
twme	time
twrn	turn
twy	try
txat	that
txe	the
txey	they
txing	thing
txis	this
txke	take
txlk	talk
txll	tell
txme	time
txrn	turn
txy	try
ty	try
tyat	that
tye	the
tyey	they
tying	thing
tyis	this
tyke	take
tylk	talk
tyll	tell
tyme	time
tyr	try
tyrn	turn
tyy	try
tzat	that
tze	the
tzey	they
tzing	thing
tzis	this
tzke	take
tzlk	talk
tzll	tell
tzme	time
tzrn	turn
tzy	try
uae	use
uake	make
ualk	talk
uall	call
uant	want
uappen	happen
uave	have
uay	say
ube	use
ubt	but
uce	use
ude	use
ue	use
uear	year
ueave	leave
uee	use
ueed	need
ueel	feel
ueem	seem
ueep	keep
uegin	begin
uelieve	believe
uell	tell
uelp	help
ueople	people
ues	use
uet	let
ufe	use
uge	use
uhat	that
uhe	use
uhey	they
uhing	thing
uhis	this
uhow	show
uie	use
uill	will
uime	time
uind	find
uit	sit
uith	with
uive	live
uje	use
uke	use
ulay	play
ule	use
ume	use
un	run
und	and
une	use
unow	know
untill	until
uoe	use
uold	hold
uome	come
uood	good
uook	look
uor	for
uork	work
uot	not
uou	you
uove	move
upe	use
upp	up
upt	put
uqe	use
ur	your
ure	use
uring	bring
urite	write
urn	turn
urom	from
urovide	provide
ury	try
us	use
usa	use
usb	use
usc	use
usd	use
usee	use
usf	use
usg	use
ush	use
usi	use
usj	use
usk	ask
usl	use
usm	use
usn	use
uso	use
usp	use
usq	use
usr	use
uss	use
usse	use
ust	just
usu	use
usv	use
usw	use
usx	use
usy	use
usz	use
ut	out
utart	start
ute	use
uther	other
utrn	turn
uue	use
uun	run
uurn	turn
uuse	use
uut	but
uve	use
uwe	use
uxe	use
uye	use
uze	use
vake	take
valk	talk
vall	call
vant	want
vappen	happen
vave	have
vay	say
vear	year
veave	leave
vee	see
veed	need
veel	feel
veem	seem
veep	keep
vegin	begin
velieve	believe
vell	tell
velp	help
veople	people
vet	let
vhat	that
vhe	the
vhey	they
vhing	thing
vhis	this
vhow	show
vill	will
vime	time
vind	find
vit	sit
vith	with
vive	live
vlay	play
vnd	and
vnow	know
vold	hold
vome	come
vood	good
vook	look
vor	for
vork	work
vot	not
vou	you
vove	move
vring	bring
vrite	write
vrom	from
vrovide	provide
vry	try
vse	use
vsk	ask
vtart	start
vther	other
vun	run
vurn	turn
vut	put
waant	want
waat	want
wabt	want
wact	want
wadt	want
waet	want
waft	want
wagt	want
waht	want
wait	want
waite	write
wajt	want
wake	make
wakt	want
walk	talk
wall	will
walt	want
wamt	want
wan	want
wana	want
wanb	want
wanc	want
wand	want
wane	want
wanf	want
wang	want
wanh	want
wani	want
wanj	want
wank	want
wanl	want
wanm	want
wann	want
wanna	want to
wannt	want
wano	want
wanp	want
wanq	want
wanr	want
wans	want
wantt	want
wanu	want
wanv	want
wanw	want
wanx	want
wany	want
wanz	want
waot	want
wappen	happen
wapt	want
waqt	want
wark	work
wart	want
wast	want
wat	want
wath	with
watn	want
watt	want
waut	want
wave	have
wavt	want
wawt	want
waxt	want
way	say
wayt	want
wazt	want
wbite	write
wbll	will
wbnt	want
wbrk	work
wbth	with
wcite	write
wcll	will
wcnt	want
wcrk	work
wcth	with
wdite	write
wdll	will
wdnt	want
wdrk	work
wdth	with
wear	hear
weave	leave
wee	we
weed	need
weel	feel
weem	seem
weep	keep
wegin	begin
wehn	when
weite	write
welieve	believe
well	will
welp	help
went	want
weople	people
were	where
werk	work
wet	let
weth	with
wfite	write
wfll	will
wfnt	want
wfrk	work
wfth	with
wgite	write
wgll	will
wgnt	want
wgrk	work
wgth	with
what	that
whatt	what
whe	the
whenn	when
whey	they
whichh	which
whing	thing
whis	this
white	write
whll	will
whnt	want
whoo	who
whow	show
whrk	work
whth	with
wiah	with
wial	will
wibh	with
wibl	will
wich	which
wicl	will
widh	with
widl	will
wieh	with
wiel	will
wierd	weird
wifh	with
wifl	will
wigh	with
wigl	will
wih	with
wihh	with
wihl	will
wiht	with
wiih	with
wiil	will
wiill	will
wiite	write
wiith	with
wijh	with
wijl	will
wikh	with
wikl	will
wil	will
wila	will
wilb	will
wilc	will
wild	will
wile	will
wilf	will
wilg	will
wilh	will
wili	will
wilj	will
wilk	will
willl	will
wilm	will
wiln	will
wilo	will
wilp	will
wilq	will
wilr	will
wils	will
wilt	will
wilu	will
wilv	will
wilw	will
wilx	will
wily	will
wilz	will
wime	time
wimh	with
wiml	will
wind	find
winh	with
winl	will
wint	want
wioh	with
wiol	will
wiph	with
wipl	will
wiqh	with
wiql	will
wirh	with
wirk	work
wirl	will
wirte	write
wish	with
wisl	will
wit	with
wita	with
witb	with
witc	with
witd	with
wite	write
witf	with
witg	with
withh	with
witi	with
witj	with
witk	with
witl	with
witm	with
witn	with
wito	with
witp	with
witq	with
witr	with
wits	with
witt	with
witth	with
witu	with
witv	with
witw	with
witx	with
wity	with
witz	with
wiuh	with
wiul	will
wive	give
wivh	with
wivl	will
wiwh	with
wiwl	will
wixh	with
wixl	will
wiyh	with
wiyl	will
wizh	with
wizl	will
wjite	write
wjll	will
wjnt	want
wjrk	work
wjth	with
wkite	write
wkll	will
wknt	want
wkrk	work
wkth	with
wlay	play
wlil	will
wlite	write
wll	will
wlll	will
wlnt	want
wlrk	work
wlth	with
wmite	write
wmll	will
wmnt	want
wmrk	work
wmth	with
wnat	want
wnd	and
wnite	write
wnll	will
wnnt	want
wnow	know
wnrk	work
wnt	want
wnth	with
wo	know
woak	work
wobk	work
wock	work
wodk	work
woek	work
wofk	work
wogk	work
wohk	work
woik	work
woite	write
wojk	work
wok	work
wokk	work
wokr	work
wold	hold
wolk	work
woll	will
wome	come
womk	work
wonk	work
wont	won't
wood	good
wook	look
woork	work
wopk	work
woqk	work
wor	work
wora	work
worb	work
worc	work
word	work
wore	work
worf	work
worg	work
worh	work
wori	work
worj	work
workk	work
worl	work
worm	work
worn	work
woro	work
worp	work
worq	work
worr	work
worrk	work
wors	work
wort	work
woru	work
worv	work
worw	work
worx	work
wory	work
worz	work
wosk	work
wot	not
woth	with
wotk	work
wou	you
wouk	work
wouldd	would
wove	move
wovk	work
wowk	work
woxk	work
woyk	work
wozk	work
wpite	write
wpll	will
wpnt	want
wprk	work
wpth	with
wqite	write
wqll	will
wqnt	want
wqrk	work
wqth	with
wrate	write
wrbte	write
wrcte	write
wrdte	write
wrete	write
wrfte	write
wrgte	write
wrhte	write
wriae	write
wribe	write
wrice	write
wride	write
wrie	write
wriee	write
wriet	write
wrife	write
wrige	write
wrihe	write
wriie	write
wriite	write
wrije	write
wrike	write
wrile	write
wrime	write
wrine	write
wring	bring
wrioe	write
wripe	write
wriqe	write
wrire	write
wrise	write
writ	write
writa	write
writb	write
writc	write
writd	write
writee	write
writf	write
writg	write
writh	write
writi	write
writj	write
writk	write
writl	write
writm	write
writn	write
writo	write
writp	write
writq	write
writr	write
writs	write
writt	write
writte	write
writu	write
writv	write
writw	write
writx	write
writy	write
writz	write
wriue	write
wrive	write
wriwe	write
wrixe	write
wriye	write
wrize	write
wrjte	write
wrk	work
wrkte	write
wrll	will
wrlte	write
wrmte	write
wrnt	want
wrnte	write
wrok	work
wrom	from
wrote	write
wrovide	provide
wrpte	write
wrqte	write
wrrite	write
wrrk	work
wrrte	write
wrste	write
wrte	write
wrth	with
wrtie	write
wrtte	write
wrute	write
wrvte	write
wrwte	write
wrxte	write
wry	try
wryte	write
wrzte	write
wse	use
wsite	write
wsk	ask
wsll	will
wsnt	want
wsrk	work
wsth	with
wtart	start
wth	with
wther	other
wtih	with
wtite	write
wtll	will
wtnt	want
wtrk	work
wtth	with
wuite	write
wull	will
wun	run
wunt	want
wurk	work
wurn	turn
wut	but
wuth	with
wvite	write
wvll	will
wvnt	want
wvrk	work
wvth	with
wwant	want
wwill	will
wwite	write
wwith	with
wwll	will
wwnt	want
wwork	work
wwrite	write
wwrk	work
wwth	with
wxite	write
wxll	will
wxnt	want
wxrk	work
wxth	with
wyite	write
wyll	will
wynt	want
wyrk	work
wyth	with
wzite	write
wzll	will
wznt	want
wzrk	work
wzth	with
xake	make
xalk	talk
xall	call
xant	want
xappen	happen
xave	have
xay	say
xear	year
xeave	leave
xee	see
xeed	need
xeel	feel
xeem	seem
xeep	keep
xegin	begin
xelieve	believe
xell	tell
xelp	help
xeople	people
xet	let
xhat	that
xhe	the
xhey	they
xhing	thing
xhis	this
xhow	show
xill	will
xime	time
xind	find
xit	sit
xith	with
xive	live
xlay	play
xnd	and
xnow	know
xold	hold
xome	come
xood	good
xook	look
xor	for
xork	work
xot	not
xou	you
xove	move
xring	bring
xrite	write
xrom	from
xrovide	provide
xry	try
xse	use
xsk	ask
xtart	start
xther	other
xun	run
xurn	turn
xut	put
yaar	year
yaer	year
yake	take
yalk	talk
yall	call
yant	want
yappen	happen
yar	year
yau	you
yave	have
yay	say
ybar	year
ybu	you
ycar	year
ycu	you
ydar	year
ydu	you
ye	they
yea	year
yeaa	year
yeaar	year
yeab	year
yeac	year
yead	year
yeae	year
yeaf	year
yeag	year
yeah	year
yeai	year
yeaj	year
yeak	year
yeal	year
yeam	year
yean	year
yeao	year
yeap	year
yeaq	year
year	hear
yearr	year
yeas	year
yeat	year
yeau	year
yeav	year
yeave	leave
yeaw	year
yeax	year
yeay	year
yeaz	year
yebr	year
yecr	year
yedr	year
yee	see
yeear	year
yeed	need
yeel	feel
yeem	seem
yeep	keep
yeer	year
yefr	year
yegin	begin
yegr	year
yehr	year
yeir	year
yejr	year
yekr	year
yelieve	believe
yell	tell
yelp	help
yelr	year
yemr	year
yenr	year
yeople	people
yeor	year
yepr	year
yeqr	year
yer	year
yera	year
yerr	year
yesr	year
yet	let
yetr	year
yeu	you
yeur	year
yevr	year
yewr	year
yexr	year
yeyr	year
yezr	year
yfar	year
yfu	you
ygar	year
ygu	you
yhar	year
yhat	that
yhe	the
yhey	they
yhing	thing
yhis	this
yhow	show
yhu	you
yiar	year
yill	will
yime	time
yind	find
yit	sit
yith	with
yiu	you
yive	give
yjar	year
yju	you
ykar	year
yku	you
ylar	year
ylay	play
ylu	you
ymar	year
ymu	you
ynar	year
ynd	and
ynow	know
ynu	you
yo	you
yoa	you
yoar	year
yob	you
yoc	you
yod	you
yoe	you
yof	you
yog	you
yoh	you
yoi	you
yoj	you
yok	you
yol	you
yold	hold
yom	you
yome	come
yon	you
yoo	you
yood	good
yook	look
yoou	you
yop	you
yoq	you
yor	you
york	work
yos	you
yot	not
youre	you're
yourr	your
youu	you
yov	you
yove	move
yow	you
yox	you
yoy	you
yoz	you
ypar	year
ypu	you
yqar	year
yqu	you
yrar	year
yring	bring
yrite	write
yrom	from
yrovide	provide
yru	you
yry	try
ysar	year
yse	use
ysk	ask
ysu	you
ytar	year
ytart	start
yther	other
ytu	you
yu	you
yuar	year
yun	run
yuo	you
yurn	turn
yut	put
yuu	you
yvar	year
yvu	you
ywar	year
ywu	you
yxar	year
yxu	you
yyar	year
yyear	year
yyou	you
yyu	you
yzar	year
yzu	you
zake	take
zalk	talk
zall	call
zant	want
zappen	happen
zave	have
zay	say
zear	year
zeave	leave
zee	see
zeed	need
zeel	feel
zeem	seem
zeep	keep
zegin	begin
zelieve	believe
zell	tell
zelp	help
zeople	people
zet	let
zhat	that
zhe	the
zhey	they
zhing	thing
zhis	this
zhow	show
zill	will
zime	time
zind	find
zit	sit
zith	with
zive	give
zlay	play
znd	and
znow	know
zold	hold
zome	come
zood	good
zook	look
zor	for
zork	work
zot	not
zou	you
zove	move
zring	bring
zrite	write
zrom	from
zrovide	provide
zry	try
zse	use
zsk	ask
ztart	start
zther	other
zun	run
zurn	turn
zut	put
